biến	kí_hiệu ( như x hay y ) được sử_dụng trong biểu_thức toán_học và lôgic để biểu_diễn cho đại_lượng biến_đổi ; làm cho thay_đổi hoặc biến thành một vật nào_đó khác ; làm cho có đặc_trưng mới ; thay_đổi từ một dạng hay môi_trường này thành một dạng hay môi_trường khác ; thay_đổi về bản_chất , mục_đích hoặc chức_năng ở cái gì đó ; lượng có_thể nhận một giá_trị bất_kì của một tập_hợp giá_trị ; yêu_cầu rời đi ngay_lập_tức ; mang đến trạng_thái hoặc điều_kiện thấp_kém hay yếu_kém hơn ; đi khỏi hoặc trốn khỏi một_cách bất_ngờ , không để người khác biết ; cái mà có_thể biến_đổi ; thứ mà chịu sự biến_đổi ; được đặc_trưng bởi sự biến_dạng hay thay_đổi về hình_dạng bên ngoài hoặc vật_chất ; trở_nên vô_hình hoặc không thấy rõ ; tan dần ra xung_quanh , đi khỏi hoặc biến_mất ; chạy biến ; chạy vắt chân lên cổ ; chuồn nhằm thoát_thân
ngập	chảy vượt qua ( giới_hạn hoặc mép của cái gì ) ; bao_phủ với ánh_sáng ; được bao_phủ hoặc chìm trong chất_lỏng ; chuyển vào một trang thái hay tình_trạng được định rõ ; lan ra trên diện rộng ( chất_lỏng , màu_sắc hay ánh_sáng ) ; bao_phủ bởi nước hoặc ngập trong nước ; lấp đầy nhanh_chóng vượt ra ngoài sức chứa ; như bằng một chất_lỏng ; bị phủ bởi nước ; lan_rộng vượt qua bề_mặt ; trở_nên đầy ; có nhiều về số_lượng , tạo ra những âm_thanh xôn_xao ; làm cho lây_lan hoặc làm ngập qua , lên trên hoặc ngang qua
nhà_thi_đấu	[]
nhà	toà nhà trong đó các thứ được lưu_giữ hoặc để trong đó ; nơi mình sống tại một thời_điểm cụ_thể ; người mang đặc_trưng nào_đó ; nơi mà mọi người sống ; công_trình có mái , tường tại một địa_điểm cố_định ; không_gian khép_kín tự_nhiên hay nhân_tạo
động	tầng địa_chất bao_gồm vùng_đất được bao quanh dưới lòng đất , có lối vào từ mặt_đất hay biển ; đặc_trưng bởi chuyển_động ; được làm cho có_vẻ như đang chuyển_động như sinh_vật sống ; chỉ một chuỗi ảnh được biểu_diễn để tạo ảo_giác chuyển_động ; có tính_chất đang chuyển_động ; có sự tiếp_xúc cơ_thể ; hang lớn hay một ngăn lớn trong hang
tĩnh	vẫn giữ nguyên không hoạt_động hay đứng yên ; chảy với tốc_độ nhỏ như vào lúc thay_đổi của thuỷ_triều ; không hoạt_động hay không được kích_hoạt ; chỉ hình_ảnh ; một bức ảnh đơn_lẻ hoặc tĩnh không được dùng để tạo ảo_giác chuyển_động ; hoặc biểu_diễn những vật_thể không có khả_năng chuyển_động
khuyết	lỗ nhỏ trên áo dùng để cài khuy
ưu	[]
cõi_tục	thuộc trần_gian hay cõi_trần ; nơi cư_trú của con_người trên mặt_đất ( trong đối_lập với Thiên_Đường hay Địa_Ngục )
cõi_âm	nơi mình đến ở sau khi chết
thủ_pháp	[]
biện_pháp	mưu_kế được thực_hiện như một phần để tiến tới mục_đích ; cách làm điều gì đó , đặc_biệt là cách có hệ_thống ; ngụ_ý một trình_tự hợp_lí ( thường theo các bước ) ; trạng_thái của các thứ nói_chung ; cách kết_quả thu được
kết_duyên	[]
thành_hôn	thực_hiện lễ cưới
cấp_tiến	đặt ở vị_trí phía trước hoặc đi trước ; có quan_điểm về chính_trị hay xã_hội thiên về cải_cách và phát_triển ; đi trước thời_đại
bảo_thủ	quan_điểm xã_hội hay chính_trị thiên về bảo_thủ ; chống lại sự thay_đổi ; khó lay_chuyển được , theo_đuổi thực_hiện một giải_pháp , hoặc một sự kháng_cự ; cố_chấp khăng_khăng giữ ý_kiến của mình
nước_lớn	quốc_gia hùng_mạnh đủ để ảnh_hưởng đến các sự_kiện trên toàn thế_giới
nguy_hiểm	chỉ mức_độ nghiêm_trọng hoặc nguy_hiểm lớn ; có_thể gây tai_hoạ lớn ; sâu_kín , dễ thay_đổi và khó lường một_cách nguy_hiểm ; có_thể gây thiệt_hại lớn , gây ra sự sợ_hãi và lo_lắng ; đặc_trưng bởi sự không an_toàn do mối nguy_hiểm hay rắc_rối có_thể xảy_ra ; cực_kì độc hoặc gây tổn_thương ; tạo ra chất_độc ; ( bệnh ) lây_lan nhanh và hậu_quả tàn_khốc ; liên_quan đến rủi_ro hay hiểm_hoạ ; cực_kì xấu_xa hay ác_độc ; có ý_nghĩa của sự hung_ác hay thích_hợp với địa_ngục ; cực_kì có hại
hoa	cơ_quan sinh_sản của những thực_vật hạt_kín , nhất_là loại có những phần rực_rỡ sắc_màu ; thực_vật được trồng để lấy hoa
nhị	bè , giọng , nhạc_cụ hay phân nhóm của dàn_nhạc có cao_độ thấp hơn hoặc phụ_thuộc vào mức thứ nhất ; cơ_quan sinh_sản đực của một bông hoa
bất_lợi	không thuận_lợi ; sự cản_trở , là nhân_tố cản_trở ; liên_quan hoặc tạo ra sự bất_lợi ; ( gió hoặc thời_tiết ) có xu_hướng cản_trở hoặc chống_đối ; không khuyến_khích hoặc chấp_thuận hoặc hài_lòng
thuận_lợi	rất sôi_nổi và sinh_lợi ; có nhiều yếu_tố hoặc điều_kiện dễ_dàng để thực_hiện việc_gì , có khả_năng đạt được sự thành_công ; có tính_chất báo trước những hoàn_cảnh thuận_lợi và may_mắn ; ( gió hoặc thời_tiết ) bình_thường , diễn_biến đúng quy_luật , có xu_hướng tạo điều_kiện thuận_lợi cho việc trồng_trọt , làm_ăn ; theo hướng mong_muốn ; thích_hợp cho sự sống hay sự phát_triển
phân_ly	[]
sum_họp	[]
nói_lắp	nói không trơn_tru , trôi_chảy , hay nhắc_đi_nhắc_lại nhiều lần một tiếng , do có tật
nói_móc	[]
vây_ép	[]
phong_toả	hành_động bao quanh vị_trí kiên_cố và cô_lập nó trong khi ở bên trong vẫn tiếp_tục hoạt_động của lực_lượng quân_sự ; sử_dụng hệ_thống gây trở_ngại
diễu_hành	đi theo hàng theo một đoàn người tuần_tự diễu bước
tuần_hành	đi theo hàng theo một đoàn người tuần_tự diễu bước
cao_trào	thời_điểm quyết_định trong một tiểu_thuyết hay một vở kịch ; sự biểu_lộ áp_đảo của cảm_xúc hoặc hiện_tượng nào_đó ; thế cân_bằng và tác_động qua_lại giữa các mặt đối_lập ( đặc_biệt là trong nghệ_thuật hoặc văn_học )
thoái_trào	trạng_thái ngưng lại , giảm_sút và suy_yếu của một phong_trào hay một sự phát_triển
thịnh	[]
suy	trải qua một cuộc suy_thoái đột_ngột và trầm_trọng
con_voi	thú lớn sống ở vùng nhiệt_đới , mũi dài thành vòi , răng_nanh dài thành ngà , tai to , da rất dày , có_thể nuôi để tải hàng , kéo_gỗ , v . v .
ngà	răng nhọn , sắc , ở giữa các răng_cửa và răng_hàm chuyên_dùng để tấn_công hoặc đào_bới ; bị say nhẹ và dễ_chịu bởi rượu hay thuốc_phiện ( đặc_biệt là cần_sa ) ; lớp bọc ngoài răng , trong_suốt và cứng có tác_dụng bảo_vệ răng ; trạng_thái bắt_đầu chếnh_choáng , mất sự kiểm_soát bản_thân do say rượu
cá_chuối	[]
cá_quả	[]
đổ_bê_tông	phủ bằng xi_măng
biếu_xén	trả tiền để nhận được sự giúp_đỡ
con_đẻ	[]
con_ruột	[]
uỷ_nhiệm	giao một nhiệm_vụ ( cho một người ) ở một cương_vị , hoặc giao một công_tác ( cho một người ) ; giao cho một nhiệm_vụ ; chuyển_nhượng cho ai ; tạo ra và giao một nhiệm_vụ hoặc trách_nhiệm ; phân_công , giao cho người khác làm công_việc nào_đó thay mình ; chuyển quyền_lực cho người nào_đó ; hành_động trao quyền để thực_hiện chức_năng nào_đó ; cung_cấp hoặc gửi những đại_diện hay đại_sứ tới đâu để thực_hiện những nhiệm_vụ nhất_định với sự uỷ_quyền chính_thức ; giao một nhiệm_vụ , trách_nhiệm hay nghĩa_vụ cho ; giao quyền cho
phân_công	giao một nhiệm_vụ ( cho một người ) ở một cương_vị , hoặc giao một công_tác ( cho một người ) ; phân_công ( một công_việc hay chỗ ở ) ; lựa_chọn cái gì đó hay người nào_đó cho một mục_đích rõ_ràng ; giao cho một nhiệm_vụ cụ_thể ; áp_đặt một nhiệm_vụ , phân trách_nhiệm cho ai ; ấn_định vào một vị_trí
bay_lượn	lơ_lửng trong không_khí ; bay hoặc lơ_lửng ở phía trên ; bay bằng hoặc như_thể bằng máy_bay ; di_chuyển qua các tầng không_khí , ở trên không
chuyển_động	có khả_năng di_chuyển dễ_dàng ( đặc_biệt từ nơi này dang nơi khác ) ; thay_đổi vị_trí ; xét cả nghĩa ẩn_dụ ; trạng_thái thay_đổi ; sự_việc tự_nhiên liên_quan đến sự thay_đổi vị_trí hay địa_điểm của cái gì đó
khêu_gợi	kích_thích ham_muốn tình_dục ; cung_cấp sự kích_thích cần_thiết ; làm say_mê hoặc sắc_sảo hơn ; gợi lên hi_vọng , sự mong_muốn hay sự tò_mò mà không được thoả_mãn ; kích_thích một_cách thích_thú hay khêu_gợi ; có sức hấp_dẫn tình_dục mạnh_mẽ
khơi_gợi	đánh_thức hoặc gợi ra một cảm_giác ; gợi lại ( tình_cảm , cảm_xúc , và sự phản_ứng )
thăng_bằng	[]
cân_bằng	có cùng số_lượng , phẩm_chất , hoặc có số_đo giống một cái khác ; ngang bằng về mức_độ , phạm_vi hoặc số_lượng ; tương_xứng nhau hoặc ( các vật ) ở trạng_thái thăng_bằng trên đĩa cân ; điều_chỉnh về kích_thước so với những thứ khác ; duy_trì trạng_thái cân_bằng ; không thay_đổi ; đưa vào sự cân_bằng hay thăng_bằng ; mang lại sự ngưng_trệ hoặc trạng_thái cân_bằng hoá_học
chọn_lựa	chọn hay được lấy từ một nhóm hay một khu_vực nhất_định ; lựa_chọn phần mong_muốn từ một nhóm hay một danh_sách ; quyết_định bằng chọn_lựa ; hành_động chọn_lựa ai hay cái gì ; việc dùng sự lựa_chọn thận_trọng ; lựa_chọn ; chọn một_cách cẩn_thận từ một nhóm ; phân_biệt và tách rời ra ; hành_động tạo ra sự lựa_chọn ; có chọn_lọc như một sự lựa_chọn hơn cái khác ; sự cân_nhắc giữa các đối_tượng
tuyển_chọn	lựa_chọn phần mong_muốn từ một nhóm hay một danh_sách ; kiểm_tra để thử_nghiệm tính thích_hợp ; chọn một_cách cẩn_thận từ một nhóm ; sự cân_nhắc giữa các đối_tượng
có_ích	có lợi hoặc đặc_trưng cho thể_chất cũng_như tinh_thần ; mang lại lợi_ích ; sẵn_sàng phục_vụ hoặc có_thể phục_vụ lâu_dài ; giúp_đỡ trong một hoàn_cảnh khó_khăn ; đang được sử_dụng hoặc phục_vụ ; có chức_năng hữu_ích ; cải_thiện tình_trạng
hữu_ích	cung_cấp sự hỗ_trợ hay thực_hiện một chức_năng hữu_ích ; có lợi hoặc đặc_trưng cho thể_chất cũng_như tinh_thần ; mang lại lợi_ích ; đang được sử_dụng hoặc phục_vụ ; có chức_năng hữu_ích
cứng_rắn	không xúc_động ; sẵn_sàng chịu_đựng cái gì đó khó hay không dễ_chịu ; không bận_tâm đến những lời biện_hộ , thuyết_phục , những yêu_cầu hay lí_lẽ ; không được ban cho sự dịu_dàng hay đa_cảm ; có cảm_xúc trái_ngược với những cảm_xúc dịu_dàng ; ( người ) khó lay_chuyển về mặt cảm_xúc ; làm cho cứng_rắn do tiếp_xúc thường_xuyên ; không nhượng_bộ
nhỏ_nhắn	[]
bội_nghĩa	không thể_hiện sự biết_ơn hay không đếm_xỉa tới công_ơn của người đã có ơn đối_với mình
biết_ơn	cảm_thấy hoặc thể_hiện sự biết_ơn ; thừa_nhận với sự biết_ơn ; biết_ơn ; bày_tỏ sự mang ơn , lời cảm_ơn hay sự biết_ơn ; thể_hiện lòng cảm_kích hoặc tỏ ra biết_ơn
lỗ_đen	[]
hố_đen	[]
vùi	nhúng , ấn , chôn sâu xuống ( có_thể mang tính ẩn_dụ )
đóng	ngăn chuyển_động ( của cái gì ) một_cách đột_ngột ; kết_thúc ; thích_hợp với trình_diễn trên sân_khấu ; đặc_biệt dùng cho miệng hay mắt ; chặn lối vào ; làm cố_định hoặc buộc chặt ; biểu_diễn trên sân_khấu hoặc nhà_hát ; gập lại hoặc đóng lại ; không mở ; được ra giá hay được kê_khai khi việc giao_dịch ngừng lại ; gắn vào hoặc đặt vào sâu hay chắc_chắn ; trở_nên kín ; đóng một vai hay một phần ; nối hay cho tiếp_xúc với nhay hay chạm các cạnh vào nhau ; đưa hay bắt đinh_vít vào dưới bề_mặt , như vào trong một lỗ đã khoan sẵn ; chặn một lối vào hoặc một đoạn đường ; hợp_thành một quỹ chung ; làm cho cửa_sổ hay trình ứng_dụng biến_mất trên màn_hình máy_tính ; có yêu_cầu phải là thành_viên mới có_thể vào ; dừng hoạt_động hay làm cho ngừng hoạt_động ; đẩy đi , đẩy tới hoặc ép bằng lực ; tác_động hoặc có ảnh_hưởng theo một_cách nhất_định , hoặc với ảnh_hưởng hay kết_quả cụ_thể ; không mở hay không_thể đi qua hay đến gần
tính_tình	tập_hợp những thuộc_tính vốn có quyết_định những hành_động và những phản_ứng có đạo_đức và có luân_lí của một người ; đặc_trưng tâm_lí của mỗi người nói_chung ; trạng_thái đặc_trưng ( thường_trú hoặc tương_đối tạm_thời ) của cảm_giác
tính_khí	tập_hợp những thuộc_tính vốn có quyết_định những hành_động và những phản_ứng có đạo_đức và có luân_lí của một người ; tính_tình và khí_chất của con_người ; đặc_trưng tâm_lí của mỗi người nói_chung
mục_sư	chức trong Công giáo , dưới Giám_mục , nhiệm_vụ chăm_lo , cai_quản một xứ giáo ; người được giao trách_nhiệm tiến_hành các nghi_lễ tôn_giáo ; giáo_sĩ đạo Cơ-đốc , là thành_viên của nhà_thờ Cơ-đốc ; người thuộc giáo_sĩ hoặc những người theo dòng tu ; thành_viên của hội tu_sĩ và là thủ_lĩnh tinh_thần của nhà_thờ Thiên_Chúa giáo
giáo_sĩ	người được giao nhiệm_vụ đặc_biệt , nhất_là những nhiệm_vụ về tôn_giáo ; tu_sĩ , người_làm mục_sư ở một hội_thánh nào_đó ; người thuộc giáo_sĩ hoặc những người theo dòng tu ; thành_viên của hội tu_sĩ và là thủ_lĩnh tinh_thần của nhà_thờ Thiên_Chúa giáo
cộng_đồng	nhóm người hay gia_đình sống cùng nhau và chia_sẻ mọi thứ ; chung_sống với nhau hay tận_hưởng cuộc_sống trong cộng_đồng hoặc các nhóm có tổ_chức ; nhóm người nói_chung ( đàn_ông , phụ_nữ hay trẻ_em ) ; không riêng_tư ; công_khai hay có liên_quan tới toàn_thể mọi người
dân_tộc	giới_hạn cho hoặc vì lợi_ích của một dân_tộc
rớ	có được thường với một_cách không ngờ
sờ	tiếp_xúc bằng một giác_quan nào_đó và chuyển_động ngang qua cái gì đó ; cảm_nhận qua xúc_giác ; kiểm_tra bằng cách chạm vào ; chạm , nâng lên hay giữ bằng tay ; làm cho tiếp_xúc trong giây_lát ; có sự tiếp_xúc cơ_thể
trả_đũa	thực_hiện hành_động đáp trả lại , thường là lấy ơn trả ơn , lấy oán trả oán ; thực_hiện việc trả_thù với một nhận_thức sai ; trả_thù vì một lỗi_lầm hoặc một sự tổn_thương do một kẻ khác gây ra cho mình ; hành_động được làm để đáp lại việc gây tổn_thương hay bực_mình ; phục_thù hoặc san bằng tỷ_số
đền_đáp	trả cho ; bồi_thường ; mang lại lợi_nhuận hoặc kết_quả ; hành_động đền_đáp ; trả bằng hiện_vật ; thi_hành hoặc đem đến sự báo_đáp nhằm công_nhận hành_vi , hành_động của ai đó ; đền_bù cho ; sự trao_đổi qua_lại một lợi_ích gì đó
tay_cầm	bộ_phận dùng để cầm điều_khiển hướng đi xe_đạp ; chỗ để cầm của một cái roi
phân_đạm	[]
liên_hệ	có ảnh_hưởng hoặc có kết_nối với các đối_tượng trong một vấn_đề ; có mối quan_hệ nào_đó với nhau ; thiết_lập mối liên_lạc với người nào_đó
nguỵ_trang	hành_động che_giấu sự tồn_tại của cái gì đó bằng cách che_khuất diện_mạo của nó ; che_giấu bằng cách thay_đổi diện_mạo , vẻ bề_ngoài ; lợi_dụng vùng tự_nhiên xung_quanh để che_giấu thứ gì đó ; làm cho không_thể phát_hiện ra ; thay_đổi hình_dáng để làm cho không_thể nhận ra
mới_tinh	sạch không tì_vết và chưa được sử_dụng ; mới hoàn_toàn hay nghuyên bản
mới_toanh	sạch không tì_vết và chưa được sử_dụng ; mới hoàn_toàn hay nghuyên bản
cột_trụ	( kiến_trúc ) cấu_trúc trụ cao và thẳng , sử_dụng để đỡ một công_trình ; người_làm chỗ dựa vững_chắc để nâng_đỡ người khác
bệ	phần dưới cùng của các vật ; trụ đỡ hay nền_móng của công_trình ( như cột hay tượng ) ; bề_mặt nhô lên theo phương nằm ngang ; vật để chống_đỡ hoặc làm nền ; phần đáy hay phần thấp nhất ; chỗ nền được xây cao hơn mặt xung_quanh để tạo sự nổi_bật cho người đứng trên đó
họp_mặt	bữa tiệc gồm bạn_bè cũ tụ_họp lại với nhau ; tụ_tập xã_hội quy_mô nhỏ , mang tính thân_mật ; tập_hợp và dành thời_gian cho nhau ; tụ_tập ở một nơi
tiệc	dịp mà mọi người có_thể tập_hợp để giao_lưu và giải_trí ; bữa tiệc lớn và ồn_ào có nhiều người ; bữa ăn được chuẩn_bị chu_đáo , có nhiều món ngon , đông người đến dự và chung vui ; nhóm người tụ_tập lại với nhau để giải_trí
lộn_xộn	trong một khối lẫn_lộn ; không gọn_gàng và ngăn_nắp ; tất_cả được trộn lẫn hoặc được hoà_trộn cùng nhau ; không được sắp_xếp theo thứ_tự ; nổi_bật bởi sự cẩu_thả nghiêm_trọng ; bẩn_thỉu và mất trật_tự ; hành_động tạo ra sự liên_kết không có trật_tự giữa các yếu_tố với những đặc_tính bị mất đi và những nét khác_biệt bị pha_trộn ; hoàn_toàn không theo thứ_tự và không đều , rối_rắm ; có sự sắp_xếp không theo trật_tự ; mang đến sự lộn_xộn cho ; thiếu ngăn_nắp hoặc trật_tự ; thiếu kỉ_luật hoặc sự kiểm_soát ; thiếu trật_tự hay thiếu sự sắp_xếp có phương_pháp ; gồm sự sắp_xếp ngẫu_nhiên của các loại khác_nhau ; thiếu cấu_trúc rõ_ràng và tính tổ_chức
gọn_gàng	( nơi chốn ) trật_tự và ngăn_nắp ; không bừa_bãi ; có sự chuẩn_bị hoặc bố_trí theo một trật_tự nhất_định ; trạng_thái của sự sắp_đặt hay vẻ bề_ngoài ; sạch_sẽ hoặc ngăn_nắp ; có đặc_trưng là sự trật_tự và sạch_sẽ về diện_mạo hoặc thói_quen ; tuyệt_đối sạch_sẽ và gọn_gàng
chủ_động	biểu_thị rằng chủ_ngữ của câu có chức_năng ngữ_nghĩa là tác_nhân gây ra sự_việc ; diễn_tả sự_kiện hoặc kích_thích hoặc quá_trình có hiệu_ứng trên các sự_kiện hoặc kích_thích hoặc quá_trình dự_trù xảy_ra sau đó ; được kiểm_soát bởi ý_thức của cá_nhân
thụ_động	thiếu năng_lượng hay ý_chí
vali	cái để đồ_đạc để mang đi khi đi du_lịch
tay_cầm	bộ_phận dùng để cầm điều_khiển hướng đi xe_đạp ; chỗ để cầm của một cái roi
đơn_tiết	[]
đơn_âm	[]
ghen_tị	ganh_tị với ; mong_muốn điều gì ; có cảm_giác ganh_tị với ; thèm_muốn một_cách ghen_tị ; ( thần_học ) sự thù_hằn và oán_giận ai trước thành_công của họ ( là một trong các tội trọng ) ; có lòng tham tột_độ ; mong_muốn những lợi_thế của người khác
ghen_ghét	có cảm_giác ganh_tị với ; thèm_muốn một_cách ghen_tị
ngả_nghiêng	đi_đứng không vững ; dáng đi không vững_chắc ; thiếu sự cương_quyết ; tròng_trành nghiêng_ngả khi bay , của máy_bay ; chuyển_động không vững ; ngả về một phía ; di_chuyển sang một bên hoặc theo một_cách không vững
sờn_lòng	thiếu sự cương_quyết
ngôn_ngữ_học	ngành khoa_học nghiên_cứu ngôn_ngữ
khoa_học	nhánh cụ_thể của tri_thức khoa_học ; phù_hợp với các nguyên_tắc hoặc phương_pháp được sử_dụng trong khoa_học ; lĩnh_vực chuyên_môn của kiến_thức
vẹo	cong hay nghiêng về một phía ; bị quay hoặc xoắn sang một bên ; nghiêng hoặc hướng về một bên ; di_chuyển sang một bên hoặc theo một_cách không vững
vẹo_vọ	[]
thu_gom	tập_hợp hoặc thu_thập cái gì ; nhóm các vật lại với nhau ; thu_hoạch những sản_phẩm tự_nhiên hay do lao_động mà có ; tập_hợp thứ gì lại với nhau
tiếp_sức	tiếp sinh_lực hay nâng cao tinh_thần
quy_trình	quá_trình hay một loạt hành_động , nhất_là có tính_chất thực_tiễn hay máy_móc , liên_quan đến một dạng_thức công_việc ; loạt hoạt_động đặc_biệt để đạt kết_quả ; hiện_tượng được duy_trì liên_tục hoặc được đánh_dấu bằng những sự thay_đổi dần_dần thông_qua một loạt những trạng_thái
sáng_tác	hoạt_động sáng_tạo của con_người ; viết nhạc ; sáng_tạo bằng các phương_tiện nghệ_thuật ; làm tác_giả của một cái gì đó ; làm ra một tác_phẩm văn_học ; hành_động tạo ra tác_phẩm viết ; tác_phẩm âm_nhạc được sáng_tác ra ; hành_động hoặc quá_trình tạo ra ra cái gì đó
thành_thị	có đặc_trưng của một cuộc_sống thành_thị , thành_phố ; khu_vực đông dân_cư , thường có công_nghiệp và thương_nghiệp phát_triển , được thành_lập theo điều_lệ của nhà_nước
thị_thành	[]
nhảy_nhót	nhảy , nhảy lên hoặc di_chuyển lên xuống , hay di_chuyển từ bên này sang bên kia ; cách đi mà các bước_đi và nhảy lò_cò xen_kẽ nhau ; hành_động tự chuyển_động nhẹ_nhàng lên trên hoặc về phía trước
nhích	chuyển sang hướng khác , sự chuyển_động đó là không tịnh_tiến ; di_chuyển rất nhẹ_nhàng
ly_tâm	dây_thần_kinh và các xung thần_kinh ; truyền_đạt thông_tin đi từ thần_kinh_trung_ương ; xu_hướng di_chuyển ra ngoài trung_tâm
hướng_tâm	thuộc về các dây_thần_kinh và các xung thần_kinh ; truyền_đạt thông_tin cảm_giác từ các giác_quan đến thần_kinh_trung_ương ; xu_hướng di_chuyển về tâm ; bên trong và hướng tới trung_tâm
cống	đường đi của nước hoặc chất_lỏng chảy qua ; ống mà qua đó chất_lỏng được chảy qua ; ống thoát nước_thải ra chất bẩn hoặc nước mặt
đường_ống	đường_dẫn gồm vật rỗng dài ( thường là hình_trụ ) sử_dụng để chứa và kiểm_soát các vật rắn , chất_lỏng hoặc khí gas ; vật rỗng , hình_trụ dài , dùng để dẫn chất_lỏng hay khí ; vật cho_phép thứ gì đó có_thể đi qua hoặc đi dọc theo đó ; ống dài bằng nhựa hoặc kim_loại để dẫn nước , dầu_khí , ga , ...
còm	[]
nhỏ_nhoi	[]
bánh_răng	bánh_xe có răng có_thể khớp với những phần máy có răng khác để thay_đổi vận_tốc , hướng đi hoặc truyền động
răng	chỗ nhô ra giống nhau trên một bánh_răng ; cái giống với răng của động_vật ; cấu_trúc giống răng ở những động_vật_không_xương_sống nằm trong miệng , ống thực_quản hoặc trên vỏ
nao_núng	không chắc_chắn hoặc yếu_ớt ; thiếu sự cương_quyết ; tạm ngừng hoặc ngập_ngừng khi_không chắc_chắn hoặc miễn_cưỡng ; thiếu sự tin_tưởng và chắc_chắn vào khả_năng của bản_thân ; đoán trước với sự sợ_hãi hoặc lo_lắng ; lung_lay trong ý_kiến hoặc quan_điểm
kiên_định	được đặc_trưng bằng quyết_tâm hay quyết_định vững_vàng ; không_thể làm cho yếu đi ; vững trong mục_tiêu hoặc niềm_tin ; được đặc_trưng bởi sự vững_chắc và kiên_định ; kiên_định với mục_đích , sự tận_tâm hay tình_cảm ; không bị lay_động về mục_đích ; không_thể thay_đổi hoặc biến_đổi đặc_biệt trong hành_vi ; kiên_định và đáng tin_cậy nhất_là ở lòng trung_thành ; đặc_tính vững_vàng và kiên_trì với mục_đích
bằng_hữu	người mà bạn biết rõ , yêu_mến và tin_tưởng
bầu_bạn	[]
thân	gần trong mối tương_quan hoặc quan_hệ ; có kinh_nghiệm bình_thường hàng ngày và phổ_biến ; không lạ_lẫm ; kết_cấu bên ngoài của một phương_tiện ; có đặc_điểm hoặc thích_hợp với một người bạn ; đặc_trưng bởi sự quen_biết , sự liên_kết hay sự thân_mật ; phần cơ_thể không bao_gồm đầu , cổ và chân_tay ; hình_trụ tạo thành_phần dài và hẹp trên một vật ; cấu_trúc tổng_thể của một sinh_vật ( động_vật , thực_vật hoặc con_người ) ; có mối quan_hệ gần_gũi thân_mật ; cơ_thể không bao_gồm đầu , cổ và các chi ; ( có quan_hệ gần_gũi về mặt tình_cảm hoặc huyết_thống ; phần cấu_trúc thon hoặc dài dùng để nâng_đỡ một thực_vật , một loại nấm , một bộ_phận của thực_vật hay cơ_quan một thực_vật
lưng	phần sau của cơ_thể người hay động_vật_có_xương_sống tính_từ cổ đến cột_sống ; phần thịt ( thường là thịt dê hoặc thịt cừu ) gồm phần xương_sống và hai dải thăn
bút_chì	bút viết hình_trụ nhọn , mảnh ; một cây chất đánh_dấu được bọc trong gỗ
lô	tập_hợp những thứ hay người được xử_lí cùng_với nhau ; khu_vực riêng của nhà_hát hoặc khán_đài , nơi một nhóm người có_thể xem cuộc trình_diễn ; sự kết_hợp trong tổng_thể của nó ; khu_vực gồm những phần đất được chia nhỏ ; số , lượng hoặc mức_độ lớn ; tầng gồm không_gian chưa phân_vùng phía trên nhà_máy , nhà_kho hoặc các không_gian thương_mại khác
cổng	mạch máy_tính với một_vài thiết_bị đầu_vào và một thiết_bị đầu_ra có_thể kích_hoạt được bởi tổ_hợp đặc_biệt của các thiết_bị đầu_vào
ổ_khoá	khoá gắn với cửa hay ngăn_kéo để giữ chắc nó ; vật hãm để gắn vào và cố_định cái gì đó
dị_bản	[]
đĩa_bay	vật_thể ( có_vẻ như ) bay mà người_ta không biết bản_chất ; nhất_là những vật_thể được coi là có nguồn_gốc ngoài Trái_đất
nguây_nguẩy	[]
ngúng_nguẩy	[]
biên_nhận	loại giấy_tờ hợp_lệ chứng_minh sự trả nợ xong hay hoàn_thành nghĩa_vụ
ứng_chiến	[]
truy_cập	thao_tác đọc hoặc viết thông_tin lưu_trữ trên máy_tính ; nhận được hoặc lấy ra từ một cơ_sở cất_trữ ; liên_quan đến thông_tin và máy_tính
thâm_nhập	thâm_nhập lẫn nhau ; vào sâu hơn theo lối đi đến ai đó hay xuyên qua ; vào mà không được phép ; đi vào một nhóm hay một tổ_chức để bí_mật theo_dõi các thành_viên
chỉ_định	giao cho một nhiệm_vụ ; gánh_vác việc_gì ; giao một nhiệm_vụ ( cho một người ) ở một cương_vị , hoặc giao một công_tác ( cho một người ) ; hành_động đưa một người vào một chức_vụ mà không phải bầu_chọn ; đưa ra ý_kiến cần_thiết phải có sự can_thiệp ; thường trong y_học ; lựa_chọn cái gì đó hay người nào_đó cho một mục_đích rõ_ràng ; đề_cử ; bổ_nhiệm cho một chức_vụ hoặc một địa_vị hoặc vị_trí ; giao cho một nhiệm_vụ cụ_thể ; tạo ra và giao một nhiệm_vụ hoặc trách_nhiệm ; ấn_định vào một vị_trí ; phân_công , giao cho người khác làm công_việc nào_đó thay mình ; xác_định phạm_vi , ranh_giới của cái gì ; dành cho_hay để cho ; cung_cấp hoặc gửi những đại_diện hay đại_sứ tới đâu để thực_hiện những nhiệm_vụ nhất_định với sự uỷ_quyền chính_thức ; giao một nhiệm_vụ , trách_nhiệm hay nghĩa_vụ cho
hạ_bút	[]
âm	những cơ chấn được truyền đi bởi một phương_tiện đàn_hồi ; cảm_giác chủ_quan của việc nghe thấy cái gì đó ; hiệu_ứng âm_thanh đặc_biệt tạo ra bởi nguyên_nhân được đưa ra ; có tính_chất nhỏ hơn số 0 ; âm_thanh gợi lên sự phát_âm bằng lời ; ở mặt âm hay ở đầu dưới của thước chia độ ; nơi mình đến ở sau khi chết ; có âm_sắc , tức_là âm hoặc hợp_âm được tổ_chức thống_nhất với giọng hay âm_chủ ; ( ngữ_âm ) đơn_vị âm_thanh tiếng_nói riêng mà không phụ_thuộc vào việc liệu nó có là âm_vị của một ngôn_ngữ nào_đó không
nguy_hiểm	chỉ mức_độ nghiêm_trọng hoặc nguy_hiểm lớn ; có_thể gây tai_hoạ lớn ; sâu_kín , dễ thay_đổi và khó lường một_cách nguy_hiểm ; có_thể gây thiệt_hại lớn , gây ra sự sợ_hãi và lo_lắng ; đặc_trưng bởi sự không an_toàn do mối nguy_hiểm hay rắc_rối có_thể xảy_ra ; cực_kì độc hoặc gây tổn_thương ; tạo ra chất_độc ; ( bệnh ) lây_lan nhanh và hậu_quả tàn_khốc ; liên_quan đến rủi_ro hay hiểm_hoạ ; cực_kì xấu_xa hay ác_độc ; có ý_nghĩa của sự hung_ác hay thích_hợp với địa_ngục ; cực_kì có hại
thăng_trầm	[]
khô_kiệt	[]
thay_thế	đặt một người hoặc một vật vào chỗ của cái gì hoặc của người nào_đó ( thường là người hay vật làm_việc không hiệu_quả , bị hỏng hoặc mất , không còn hoạt_động như mong_đợi ) ; hành_động thay_đổi cái này hay vị_trí này thành cái khác , vị_trí khác ; hành_động đặt một vật hay một người vào vị_trí của vật hay người khác ; trở_thành vật thay_thế hoặc người thay_thế ; đặt vào vị_trí của một cái khác ; đổi chỗ những vật có chức_năng tương_đương nhau ; hành_động thay_đổi cái này thành cái khác , vị_trí này thành vị_trí khác ; đảm_nhiệm vị_trí của ; tính_chất hoạt_động hay được dùng để thay cái khác ; hoạt_động như một vật thay_thế hoặc người thay_thế ; chiếm chỗ hay di_chuyển vào một vị_trí
biến_đổi	thay_đổi hoặc sửa_đổi về hình_dáng , diện_mạo hoặc bản_chất ; thay_đổi theo tính_chất , mục_đích hoặc chức_năng ; trải qua sự thay_đổi hóa_học ; hành_động thay_đổi cái gì đó ; chuyển_đổi ( một dạng năng_lượng ) sang một dạng khác ; thay_đổi về cấu_trúc hoặc dáng_vẻ bề_ngoài ; tăng hoặc giảm ( một dòng_điện_xoay_chiều hoặc điện_áp ) ; trải qua sự thay_đổi , trở_nên khác_biệt với cái ban_đầu , mất đi bản_chất bản đầu của nó ; thay_đổi từ một dạng hay môi_trường này thành một dạng hay môi_trường khác ; trở_nên khác_biệt trong quá_trình phát_triển ; tạo nên sự thay_đổi , biến_đổi hay khác_biệt ; thay_đổi về hình_dáng hoặc đặc_tính mà không trở_thành cái khác ; bị làm cho hoặc trở_nên khác đi_về bản_chất hoặc hình_dáng ; thay_đổi về hình_thức hay đặc_điểm ; được đặc_trưng bởi sự biến_dạng hay thay_đổi về hình_dạng bên ngoài hoặc vật_chất ; trở_nên khác_biệt mà không mất đi những đặc_trưng hoặc những thuộc_tính cốt_yếu ; biến_đổi về chất , không còn giữ được tính_chất ban_đầu ; thay_đổi thành một trật_tự hay trình_tự mới ; trở_nên khác trước , đặc_biệt khi điều_kiện hay hoàn_cảnh khác trước
ban_công	nền nhô ra từ tường của một toà nhà và được bao quanh bởi một lan_can , tường chắn hay rào_chắn ; phần sàn nhô ra ngoài nhà , xung_quanh có lan_can , có cửa thông vào phòng
lan_can	rào_chắn ở cầu_thang hay ban_công để bảo_vệ khỏi bị ngã ; thành_luỹ gồm bức tường thấp
dưới	( so_sánh hơn của ^ little ^ dùng với danh_từ khối_lượng ) từ chỉ trạng_thái không nhiều bằng về mặt lượng hoặc độ ; ( so_sánh hơn của few dùng với danh_từ đếm ) lượng từ chỉ trạng_thái số gì đó nhỏ hơn ; có quỹ_đạo nằm giữa mặt_trời và quỹ_đạo trái_đất ; thấp hơn ở cấp_bậc hoặc vị_trí ; thấp hơn ; nằm dưới một cái khác ; thấp hơn so với điểm tham_chiếu ; được viết hoặc in phía dưới và về bên của một kí_tự khác
trên	vượt_trội trong cấp_bậc hay thành_tựu ; cao hơn về địa_điểm hay vị_trí ; cái ở trên trong hai cái ; có thứ_hạng cao hơn ; được viết hoặc in phía trên và về bên của một kí_tự khác
kháng_cự	hành_động đối_lập với ; từ_chối tuân theo ; cưỡng lại , không để bị khuất_phục theo sức_mạnh của một cái gì đó ; chống_đối hay ngăn_chặn bằng sự cản_trở lại ; phản_đối và làm giảm hiệu_lực bằng những hành_động ngược_lại ; phản_đối ( một_cách quả_quyết ) ; làm cho có sự kháng_cự lại ; chống lại ai hoặc cái gì đó để tự_vệ
phản_đối	cưỡng lại ; không ủng_hộ ( một hành_động hay đề_xuất , v . v . ) ; hành_động đối_lập với ; từ_chối tuân theo ; hành_động chống lại hay phản_đối ; không tuân theo những tục_lệ hay những học_thuyết được lập ra , đặc_biệt về tôn_giáo ; từ_chối vì không có cơ_sở , không đúng hay không công_bằng ; ( thường theo sau bởi ` to ) chống_đối mạnh_mẽ ; hành_động thể_hiện sự không đồng_tình mạnh_mẽ ; đưa ra sự phản_đối chính_thức trong một toà_án ; phản_đối chính_thức bằng luật_pháp ; tranh_luận nhằm phản_đối hay khác_biệt về ý_kiến ; phá_bỏ các tục_lệ đã được thiết_lập ; thể_hiện rõ sự phản_đối thông_qua hành_động hay lời_nói ; được đặc_trưng hoặc thể_hiện sự phủ_định hay từ_chối ; không có tính_chất tích_cực ; đưa ra sự phản_đối ; phản_đối bỏ_phiếu ; từ_chối việc tán_thành ; cự_tuyệt sự đồng_ý ; thể_hiện hoặc đưa ra sự phản_đối , hay chỉ_trích hoặc biểu_thị sự bất_đồng quan_điểm ; thực_hiện phản_đối ; phản_đối cái gì đó mà mình không tán_thành hay đồng_ý ; thốt ra những lời phản_kháng ; xem như xấu hoặc sai ; tranh_đấu chống lại hoặc kháng_cự mạnh_mẽ ; không được kéo_dài hoặc duy_trì bằng hỗ_trợ phi vật_chất ; khuynh_hướng không chấp_nhận ai đó trong nhóm ; đặt vào thế bất_lợi ; không thích hoặc thể_hiện sự phản_đối
cầm	di_chuyển trong khi hỗ_trợ , cả bằng xe_cộ hoặc bằng tay hoặc bằng cơ_thể ; mang một cái gì hoặc đưa một người theo mình tới một nơi nào_đó ; mang theo bên mình ; có trong tay ; tiếp_xúc hoặc giữ bằng ngón_tay ; cầm_nắm bằng tay theo quy_luật tự_nhiên ; ngăn_chặn dòng_chảy của chất_lỏng ; chạm , nâng lên hay giữ bằng tay ; có và sử_dụng ; cầm hoặc giữ bằng tay hoặc cầm chặt ; lấy lên bằng tay ; đưa ra để đảm_bảo hay làm tài_sản thế_chấp ; việc mượn tiền và đặt một món đồ để làm_tin
rờ_mó	chạm , nâng lên hay giữ bằng tay ; vuốt_ve nhằm thoả_mãn nhục_dục ; có sự tiếp_xúc cơ_thể
vế	[]
vai_vế	[]
vắng_lặng	sự yên_lặng và vắng_vẻ
ồn_ào	được đặc_trưng bởi hay tạo ra âm_thanh với âm_lượng hay cường_độ lớn ; ồn_ào một_cách khó_chịu và rõ_ràng ; gào khóc lớn ; đầy hoặc đặc_trưng bởi âm_thanh lớn và chói tai ; ồn_ào do hoạt_động ; có nhiều âm_thanh , tiếng_động vang lên làm cho khó nghe , khó_chịu , như tiếng của bầy ong
xót_thương	chia_sẻ nỗi đau của
đau_lòng	khiến cho_hay đặc_trưng bởi sự đau_buồn hay đau_đớn ; cảm_thấy đau_buồn
găng_tay	đồ mặc ở tay ; đồ đeo tay , phủ kín bàn_tay và cổ_tay
quần_áo	đồ để mặc ; quần_áo nói_chung ; đồ_dùng để mặc , như quần , áo ... ( nói khái_quát ) ; vật che_chắn được thiết_kế để mặc cho người ; quần_áo được kết_hợp với nhau ; đồ mặc với phong_cách đặc_biệt hay mặc vào dịp đặc_biệt
lộp_bộp	[]
lộp_độp	[]
sinh_vật_cảnh	[]
đồng_dao	[]
lặn	di_chuyển trong nước ; tự làm cho mình chìm hẳn xuống dưới mặt_nước ; ( sinh_vật_học ) việc sản_xuất kiểu hình đặc_trưng chỉ khi gen tương_ứng của nó đồng_nhất ; bơi dưới nước ; biến_mất ngoài đường chân_trời ; có_vẻ như đang đi xuống ; chìm xuống dưới bề_mặt ; hay đi dưới nước
mọc	xuất_hiện trên da ; xuất_hiện , thuộc về các thiên_thể ; có sự thay_đổi hoặc trải qua sự thay_đổi ( thể_chất hoặc thuộc_tính ) ; nhô lên khỏi bề_mặt ; ( răng ) đâm xuyên qua nướu ; sản_sinh ra sự sinh_dưỡng
bồ_bịch	mối quan_hệ tình_dục bí_mật hay trái đạo_lí
nhân_tình	người mà yêu ai đó hoặc được ai đó yêu ; người mà được yêu bởi một người khác ; người được chọn để nhận_lời chúc_mừng vào ngày Lễ_Tình nhân
bằng_chứng	cái thực_tế dùng để chứng_minh giúp thiết_lập chân_lí về một điều gì đó ; cơ_sở cho niềm_tin hay sự không tin ; tri_thức mà trên đó niềm_tin được xây_dựng ; vật_thể hoặc lời_nói đưa ra trước tòa_án và dùng để tham_khảo khi đưa ra bằng_chứng ; thông_tin về những tình_hình đang diễn ra hay những sự_kiện đã diễn ra ; ( luật_pháp ) vật được tạo ra để bác_bỏ sự_thật đang được điều_tra làm rõ tại tòa_án ; cái gì đó phục_vụ như bằng_chứng ; dấu_hiệu cho thấy điều gì đó là hiển_nhiên ; thông_điệp phi ngôn_ngữ
chứng_cứ	cái thực_tế dùng để chứng_minh giúp thiết_lập chân_lí về một điều gì đó ; cơ_sở cho niềm_tin hay sự không tin ; tri_thức mà trên đó niềm_tin được xây_dựng ; vật_thể hoặc lời_nói đưa ra trước tòa_án và dùng để tham_khảo khi đưa ra bằng_chứng ; ( luật_pháp ) vật được tạo ra để bác_bỏ sự_thật đang được điều_tra làm rõ tại tòa_án ; dấu_hiệu cho thấy điều gì đó là hiển_nhiên ; thông_điệp phi ngôn_ngữ
hạ_màn	[]
mở_màn	bắt_đầu di_chuyển ; đầu_tiên hoặc bắt_đầu
ca_tụng	thể_hiện sự tán_thành ; biểu_thị sự kính_trọng hoặc quý_trọng ; thể_hiện sự ngưỡng_mộ một_cách công_khai và mãnh_liệt ; truyền_đạt hoặc giống như một lời khen ; trao_tặng vinh_quang cho ai đó ; dành lời khen_ngợi , khen_tặng cho ai ; gán tầm quan_trọng xã_hội to_lớn cho
đoàn_kết	gắn_kết lại với nhau là bởi mối quan_hệ xã_hội , văn_hoá ; hành_động phối_hợp hay liên_kết trong một mục_đích hay niềm_tin chung ; tập_hợp lại vì một mục_đích , hoạt_động hay sự_nghiệp chung , hoặc trong cùng một hoàn_cảnh
ngày	một ngày cụ_thể trong tháng ; khoảng thời_gian từ khi mặt_trời mọc đến khi mặt_trời lặn , khi bên ngoài vẫn còn sáng ; ngày cụ_thể được quy_định là thời_điểm cái gì đó diễn ra ; bất_kì ngày nào trong số bảy ngày trong tuần ; ngày được dành cho một mục_đích hay lễ kỉ_niệm nhất_định ; ngày , tháng , hay năm cụ_thể ( thường tính theo Công_lịch ) mà một sự_kiện đã diễn ra ; thời_gian Trái_Đất hoàn_thành một vòng_quanh trục của nó ; ngày được tính_từ nửa_đêm này đến nửa_đêm sau ; khoảng thời_gian một hành_tinh cụ_thể ( như Sao_Hoả ) xoay trọn một vòng_quanh trục của nó
đêm	khoảng thời_gian giữa hoàng_hôn đến lúc nửa_đêm ; thời_gian để ngủ ; thời_gian sau khi mặt_trời lặn và trước khi mặt_trời mọc khi ngoài_trời còn tối ; phần tối của kì ngày_đêm , được coi là đơn_vị tính thời_gian
lan_can	rào_chắn ở cầu_thang hay ban_công để bảo_vệ khỏi bị ngã ; thành_luỹ gồm bức tường thấp
rào	chướng_ngại_vật gồm thanh nằm ngang và các cột chống ; cản_trở hay hạn_chế bằng hoặc như bằng một hàng_rào ; bao quanh bằng một hàng_rào cọc để làm vững_chắc tuyến phòng_ngự ; vây quanh để bắt từ_bỏ ; vây quanh hoặc quy_định giới_hạn cho hàng_rào hoặc như với hàng_rào ; đặt rào_chắn ; vây quanh bằng hàng_rào ; bao quanh bằng rào_chắn ; chia tách bằng rào_chắn ; thứ được dùng để duy_trì sự chia_cắt bằng cách ngăn tầm nhìn hay đường đi ; được đóng vào hoặc vây xung_quanh hoặc chứa ở bên trong
trở_lại	quay lại bất_ngờ và giáp_mặt ở hướng khác , về cả nghĩa_đen lẫn nghĩa_bóng ; được khôi_phục lại ; theo hướng ngược_lại ; đi hoặc trở_về địa_điểm , trạng_thái hoặc hoạt_động nơi người đó đã ở và đã từng làm trước đấy ; đi_lại một vùng_đất nào_đó thêm lần nữa ; gợi lên trong tâm_trí ; trở_lại vị_trí hoặc tình_trạng trước đó ; nhớ lại hoặc nói lại về chuyện nào_đó ; trở_lại với trạng_thái trước đó
đảo_ngược	chuyển theo hướng ngược_lại ; làm cho di_chuyển theo hướng ngược_lại ; ở vị_trí mà đỉnh và đáy đảo_ngược nhau ; sự lộn ngược ; đổi đầu ; đảo_ngược ( quay ngược_lại ) về trật_tự , bản_chất , hoặc tác_dụng ; đảo_ngược ( một hướng , thái_độ , hoặc quá_trình hành_động ) ; thay_đổi ngược_lại về thứ_tự hoặc mối quan_hệ ; gây ra một sự đảo_ngược hoàn_toàn ; đổi ngược vị_trí , trật_tự , quan_hệ , hay điều_kiện ; ( tác_phẩm âm_nhạc ) tạo ra sự đảo_ngược ; thay_đổi về phía ngược_lại
nhạc_nhẹ	[]
tiểu_học	[]
tự_do	sự_kiện kết_thúc thắng_lợi của cuộc Cách_mạng Mĩ ; cho_phép phản_ứng tự_phát ; ( bóng trong thể_thao ) không thuộc quyền_sở_hữu hoặc kiểm_soát của bất_kì cầu_thủ nào ; trạng_thái thoát khỏi sự kiểm_soát hay ảnh_hưởng của một người hay nhiều người khác ; sự tự_do lựa_chọn ; thoát khỏi sự giam_cầm ; trạng_thái không bị giam_cầm hoặc không bị làm nô_lệ ; trạng_thái không có sự ràng_buộc , hạn_chế về các mặt nào_đó ; không bị giam_cầm hay ở trong tình_trạng nô_lệ ; không bị hạn_chế hay bị kiềm_chế ; dễ thay_đổi ; không phụ_thuộc vào cửa_quyền , chính_thống hay truyền_thống ; có_thể hành_động theo ý_muốn ; không bị cản_trở ; không bị sức_ép hay sự kiềm_chế nào ngăn lại
đức_tính	tính tốt , hợp với đạo_lí làm người
hợp_nhất	liên_kết hoặc kết_hợp ; kết_hợp hay hợp_nhất với thứ gì đó đã tồn_tại ; hành_động phối_hợp hay liên_kết trong một mục_đích hay niềm_tin chung ; kết_hợp và phối_hợp các yếu_tố khác_nhau thành một chỉnh_thể ; có gắn với nhau ; trở_nên một ; tạo thành một tập_đoàn ; làm cho hoặc trở_thành một đơn_vị duy_nhất ; được biến thành một tổng_thể hoặc thêm vào một thực_thể khác ; biến thành tổng_thể hoặc làm một phần của tổng_thể ; gộp lại với nhau thành một tổng_thể hay hệ_thống duy_nhất ; tập_hợp lại vì một mục_đích , hoạt_động hay sự_nghiệp chung , hoặc trong cùng một hoàn_cảnh ; gộp bằng cách hợp lại ; hợp lại thành một ; có một sự sum_họp ; hợp lại ; không phân_biệt ; được dùng cho tất_cả các chủng_tộc hay các nhóm
liên_kết	thành_lập một liên_kết hoá_học với ; tạo ra mối quan_hệ logic hay nhân_quả ; liên_lạc với các thành_viên và trong phạm_vi một nhóm ; thêm vào từ một nguồn khác ; hành_động gắn_kết nhiều thứ lại để hình_thành tổng_thể mới ; hành_động kết_giao hay tham_gia với những người khác ; trở_thành bạn đồng_minh hoặc cộng_sự , như theo một thoả_thuận hay sự gắn_kết ; có tính_chất tham_gia và kết lại với nhau ; của một hợp_chất hữu_cơ ; có chứa hai hoặc nhiều liên_kết đôi , mỗi liên_kết đôi cách nhau bằng một liên_kết đơn ; liên_kết hoặc kết_hợp ; tham_gia vào sự liên_kết hay hoạt_động ; nắm giữ được phần_tử , chất_liệu hay vật_liệu khác trong liên_kết hoá_học hay vật_lí ; gắn_kết với nhau đặc_biệt trong cặp hay trong nhóm ; được đặc_trưng bởi sự thống_nhất ; tham_gia vào một thực_thể duy_nhất ; thiết_lập một quan_hệ hay một mối quan_hệ ; hành_động phối_hợp hay liên_kết trong một mục_đích hay niềm_tin chung ; tham_gia vì mục_đích chung hay trong sự hoạt_động chung ; đem hai vật nối lại với nhau ; đưa vào một quan_hệ chung , bổ_sung hoặc tương_hỗ ; cung_cấp cho đối_tác ; kết_hợp lại cùng một mục_đích chung ; ở trong sự kết_hợp hay hành_động kết_hợp với ; làm cho các thành_tố rời_rạc kết_nối hoặc liên_kết với nhau ; có gắn với nhau ; tạo thành một tập_đoàn ; hành_động như một người cộng_sự ; có tính_chất kết_hợp từ hai thứ trở_lên
hoàng_tộc	[]
hoàng_gia	[]
đầu_mối	bằng_chứng giúp giải_quyết một vấn_đề ; chỗ mà ở đó các phần hoặc các vật được nối lại với nhau ; địa_điểm nơi hai hoặc nhiều vật giao nhau
chỗ	nơi một thứ hay một người đứng ; cơ_hội kiếm việc_làm hoặc đề_bạt ; thuộc_tính không_gian của một nơi chốn mà một vật được định_vị ; thứ_tự trong hệ_thống phân_cấp hoặc trong một tổ_chức ; nơi mình sống tại một thời_điểm cụ_thể ; bất_kì khu_vực nào được dành cho một mục_đích nhất_định ; không_gian dành để ngồi ( như trong nhà_hát , tàu hoặc máy_bay ) ; chi_tiết hay điểm ; vị_trí trừu_tượng trong trí_óc ; khu_vực quy_định sẵn trên sân bóng nơi cầu_thủ đập bóng , cầu_thủ bắt bóng hay huấn luận viên đứng ; mục trong một danh_sách hay trong một chuỗi thông_tin ; phần không_gian nhất_định mà cái gì đó chiếm lấy ; điểm được xác_định dựa trên những đặc_tính bề_mặt của một khu_vực nào_đó ; vị_trí ( nói một_cách ẩn_dụ ) của một vật gì đó ; không_gian dành cho chuyển_động ; khu_vực mà trên đó thứ gì đó được đặt hoặc sẽ được đặt ; người nào_đó chơi trò_chơi đánh_bài ; địa_vị xã_hội tương_ứng với hoàn_cảnh của mình
tinh_luyện	loại_bỏ tạp_chất , tăng nồng_độ , và tách ra thông_qua quá_trình chưng_cất ; làm cho đặc hơn , mạnh hơn hoặc tinh_khiết hơn ; nâng_cấp hoặc làm cho hoàn_hảo nhờ tỉa_tót hoặc đánh_bóng ; bỏ được tạp_chất nhờ xử_lí ; chuyển thành trạng_thái nguyên_chất , không bị pha_tạp , hoặc tinh_khiết ; tách_biệt với vật_chất không liên_quan hoặc làm sạch từ các tạp_chất
hoá_lỏng	làm cho ( một chất_rắn ) thành dạng lỏng , như bằng cách đốt nóng ; trở_thành chất_lỏng hoặc dịch khi bị đun nóng ; trở_thành chất_lỏng ; làm cho một chất_khí hoặc hơi_nước chuyển thành một chất_lỏng
bí_hiểm	giống như lời dự_đoán trong sự mơ_hồ của suy_nghĩ
bí_mật	phân_loại các thông_tin , tài_liệu ; giấu không cho lưu_hành rộng_rãi ; được chỉ_đạo với hay đặc_trưng bởi những mục_đích và phương_pháp bí_mật ; đặc_điểm của việc giữ kín những thông_tin không cho người khác biết ; được lập nên và thực_hiện một_cách kín_đáo ; điều cần phải giữ kín đối_với người khác ( đặc_biệt là thông_tin không được tiết_lộ ) ; không thể_hiện ra ; bị che giấy khỏi việc biết hay dùng chung ; ( thuộc về thông_tin ) được truyền đi một_cách bí_mật ; bí_mật hoặc được giấu đi ; không được hành_động , hoạt_động hay cho thấy hoặc thừa_nhận công_khai ; kín_đáo và bí_mật nhưng hèn_hạ ; truyền đi một_cách bí_mật ; nằm ngoài những gì được lộ ra hay được công_khai ( đặc_biệt là bị giấu kín hay bị che_đậy một_cách cố_tình ) ; được giới_hạn cho những người cụ_thể
chung_tình	[]
phụ_bạc	có đặc_tính hoặc đặc_điểm của một kẻ phản_bội ; quan_hệ tình_dục với người khác , không phải là vợ hoặc chồng của mình trong hôn_nhân ; giao_nộp cho kẻ_thù vì phản_bội ; có quan_hệ tình_dục với người khác ngoài chồng hoặc vợ , bạn_trai hoặc bạn_gái ; không trung_thành với người bạn_đời hoặc người_yêu
bàn_cãi	làm cho cái gì trở_thành chủ_đề bàn_luận , tranh_cãi , kiện_tụng ; có sự không đồng_thuận về việc_gì ; liên_quan vào_cuộc tranh_cãi ; có những ý_kiến khác_nhau ; bàn_cãi gay_gắt với một người khác
cân_nhắc	tìm_hiểu kĩ , nghĩ kĩ_càng ; nghĩ một_cách cẩn_thận ; đặt lên bàn cân ; lưỡng_lự về điều gì đó ; ngập_ngừng giữa các quan_điểm hoặc hướng hành_động mâu_thuẫn ; cân_nhắc tới , có ý_định ; đắm_chìm trong suy_tư , sự cân_nhắc , hoặc cuộc tranh_luận ; xem_xét cẩn_thận và sáng_suốt ; thực_hiện việc xem_xét ; tính đến ; cân_nhắc để làm ví_dụ minh_hoạ ; thận_trọng , xem_xét và chưa đưa ra được quyết_định ; cân_nhắc khi đưa ra một quyết_định ; sự xem_xét cẩn_trọng ; sự cân_nhắc và suy_nghĩ tập_trung
nhảy_cao	nhảy_cao nhất có_thể qua một thanh xà_ngang ; cuộc_thi nhảy qua xà_ngang ; nhảy càng cao càng tốt
ném_đĩa	cuộc_thi trong đó người thi ném một vật_thể hình đĩa đi càng xa càng tốt
bánh_hỏi	[]
bánh_giò	[]
tiếng_chuông	âm_thanh của tiếng chuông kêu ; âm_thanh khi chuông được rung lên
âm_thanh	những cơ chấn được truyền đi bởi một phương_tiện đàn_hồi ; cảm_giác chủ_quan của việc nghe thấy cái gì đó ; hiệu_ứng âm_thanh đặc_biệt tạo ra bởi nguyên_nhân được đưa ra ; phần nghe được của một tín_hiệu truyền_dẫn ; âm_thanh gợi lên sự phát_âm bằng lời ; sự_việc xảy_ra đột_ngột có_thể nghe thấy được
tha_thẩn	đi chỗ này chỗ kia không mục_đích rõ_ràng
thơ_thẩn	đi thong_thả và không có mục_đích rõ_ràng
phôi_bào	tế_bào hình_thành trong giai_đoạn phân cắt trứng đầu_tiên
tế_bào	tổ_chức được coi như một phần của nhóm xã_hội lớn hơn ; ( sinh_vật_học ) đơn_vị có chức_năng và cấu_trúc cơ_bản của tất_cả các cơ_thể sống ; chúng có_thể tồn_tại như những đơn_vị độc_lập của sự sống hoặc có_thể hình_thành các cụm khuẩn hay các mô như trong lớp thực_vật và động_vật bậc cao
thuyền	thuyền nhỏ mớn_nước nông có các ván ngang chéo nhau tạo chỗ ngồi và các cọc chèo cho mái_chèo mà nhờ nó thuyền được đẩy đi ; thuyền nhỏ và nhẹ , hai đầu nhỏ gọn , được đẩy đi bằng mái_chèo ; tàu nhỏ đi trên nước ; thuyền nhỏ được đẩy đi bằng mái_chèo , buồm hoặc động_cơ
bánh_lái	tay_lái hình_tròn để điều_khiển bánh_lái của tàu_thuỷ ; ( hàng_hải ) thiết_bị lái tàu gồm một chiếc đĩa được lắp bằng bản_lề thẳng_đứng ở mũi tàu ; bộ_phận xoay được , được dùng để điều_khiển hướng đi của tàu_thuỷ ; thiết_bị cơ_khí điều_khiển tàu_thuỷ ; tay_quay dùng để xoay bánh_lái trên tàu_thuyền ; bộ_phận xoay được dùng để đổi hướng đi của phương_tiện vận_tải
nấp	đang trốn hay trốn khỏi tầm nhìn , vì sự bảo_vệ hay sự an_toàn ; giấu mình vào nơi kín_đáo cho không lộ ra , cho khó thấy
hiện	biểu_thị một_số ghi chính_xác ; của các máy đo và các dụng_cụ đo ; hiển_thị , ví_dụ như tỉ_số trong các trò_chơi game hoặc thể_thao
cất	mang linh_hồn ai đó lên thiên_đường ; chiết_xuất bằng quá_trình chưng_cất ; trông_coi để không bị mất_mát , tổn_hại để dùng vào việc cá_nhân hay việc đặc_biệt ; trải qua quá_trình chưng_cất ; nơi ngoài tầm nhìn ; giữ bí_mật ; thi_công , tạo hoặc dựng lên ; đặt vào nơi lưu_trữ ; phát ra âm_thanh ; tìm chỗ cho và cất đi để dự_trữ ; để vào một chỗ nhất_định , thường là kín_đáo hoặc chắc_chắn , nhằm giữ lại trong khi chưa dùng đến ; duy_trì để sử_dụng và phục_vụ ; cất hay cho vào trong gara ; cung_cấp hoặc trang_bị một lượng gì đó ; cất ( thứ gì đó ) vào một nơi bí_mật , thường mang nghĩa xấu
giấu	giữ bí_mật cái gì ; che_giấu cái nhìn thấy hay sự nhận_biết ; che_giấu ( cảm_xúc ) với người khác ; giữ kín theo một_cách giấu_giếm hoặc che_đậy ; che_phủ như_thể bằng vải liệm ; nơi ngoài tầm nhìn ; giữ bí_mật ; giấu đi ; giữ cho khỏi bị người khác khôngtrông thấy ; bí_mật hoặc được giấu đi ; không được hành_động , hoạt_động hay cho thấy hoặc thừa_nhận công_khai ; giấu đi bằng một diện_mạo giả ; tìm chỗ cho và cất đi để dự_trữ ; cất hay cho vào trong gara ; làm cho người khác không_thể nhìn thấy , không_thể tìm ra được ; ngăn_cản khỏi sự quan_sát hay phát_hiện ra ; cất ( thứ gì đó ) vào một nơi bí_mật , thường mang nghĩa xấu
âm	những cơ chấn được truyền đi bởi một phương_tiện đàn_hồi ; cảm_giác chủ_quan của việc nghe thấy cái gì đó ; hiệu_ứng âm_thanh đặc_biệt tạo ra bởi nguyên_nhân được đưa ra ; có tính_chất nhỏ hơn số 0 ; âm_thanh gợi lên sự phát_âm bằng lời ; ở mặt âm hay ở đầu dưới của thước chia độ ; nơi mình đến ở sau khi chết ; có âm_sắc , tức_là âm hoặc hợp_âm được tổ_chức thống_nhất với giọng hay âm_chủ ; ( ngữ_âm ) đơn_vị âm_thanh tiếng_nói riêng mà không phụ_thuộc vào việc liệu nó có là âm_vị của một ngôn_ngữ nào_đó không
gốc	thuộc cấp_bậc , tầm quan_trọng hay giá_trị đầu_tiên ; trực_tiếp và tức_thời chứ không phải thứ cấp ; ( hoá_học ) hai hay nhiều nguyên_tử liên_kết với nhau như một đơn_vị duy_nhất và tạo thành một phần của phân_tử ; ( thông_tin ) không phải gián_tiếp hay thông_qua trung_gian ; trước tất_cả những thứ khác về thời_gian hay thứ_tự thực_hiện ; biến_cố mà là khởi_đầu , phần đầu hay giai_đoạn đầu của các biến_cố kế_tiếp ; ( thuộc về ) đặc_trưng hay truyền_thống của nơi sinh_ra ; phát_sinh từ hoặc đi đến căn_nguyên hay nguồn_gốc ; trước tất_cả những thứ khác trong thời_gian , không_gian hoặc mức_độ ; phần gốc của một cây ; ( ngôn_ngữ_học ) hình_thái của một từ sau khi loại_bỏ tất_cả các phụ_tố ; bộ_phận của cây nơi rễ đâm chồi hoặc cành cây gần rễ nhất ; ( lá cây ) có vị_trí ở gốc của cây hay thân cây ; nhất_là mọc trực_tiếp từ rễ , thân rễ hoặc thân giống như rễ
đặt	đặt vào hay gắn chặt vào hay gắn trên một chân_đế ; đặt vào trong một vị_trí thẳng_đứng ; làm cho ở trong một địa_điểm cụ_thể nào_đó ; giao cho một vị_trí ; đưa vào một vị_trí nhất_định hoặc khiến cho vận_hành chính_xác ; sắp_xếp thành chồng ; đặt ( thứ gì đó ở đâu_đó ) một_cách chắc_chắn ; đặt tạm_thời ; đặt theo chiều nằm ngang ; đặt hay để trên mặt_đất ; đăng_kí để đặt phòng khách_sạn ; để một điều gì đó ( ví_dụ : niềm_tin ) vào việc_gì đó ; đặt vào một vị_trí mà sẽ phục_hồi lại tình_trạng ban_đầu ; khiến cho ngồivào một vị_trí cố_định ; khiến cho đậu hoặc ngồi ; đặt_để được chú_ý ; đặt ai vào một tình_thế hay vị_trí cụ_thể ; chuẩn_bị và cung_cấp thiết_bị cần_thiết cho việc thực_hiện hoặc thực_hành ; làm cho ở vào một tình_trạng , một mối quan_hệ nào_đó ; đặt ( những hạt_giống , cây giống hoặc cây ) vào trong đất ; sắp_đặt theo một chuỗi liên_tiếp ; ấn_định vào một vị_trí ; đặt hay để theo một thứ_tự nhất_định ; hành_động để thứ gì ở nơi nào_đó ; quy cho_hay dành cho ; phân_công vào một vị_trí ; hành_động đưa cái gì đó vào một nơi xác_định ; hành_động mang lại kết_quả là cái gì đó hình_thành ; thực_hiện sự sắp_xếp cho cái gì đó ; yêu_cầu một cái gì ; để với lực mạnh ; cách những phần hay những nhân_tố được sắp_xếp
thả_lỏng	trở_nên lỏng_lẻo hoặc không bị ràng_buộc ; làm cho bớt khắt_khe hay nghiêm_khắc ; ở trong trạng_thái nghỉ_ngơi ; làm cho thân người mềm_dẻo hơn bằng cách duỗi ra , như_thể để chuẩn_bị cho các hoạt_động thể_lực
chỉnh_hình	[]
tiểu_học	[]
tẩy	gỡ bỏ hoàn_toàn khỏi kí_ức hay trí_nhớ ; loại_bỏ bằng cách dùng nước hoặc chất_lỏng và xà_phòng hay một_số chất làm sạch khác ; đánh_dấu để xoá đi , chà đi , hoặc tẩy bỏ ; làm sạch bằng quá_trình hoá_học ; xổ mạnh ; vật làm_bằng cao_su ( hay chất tổng_hợp với các đặc_tính tương_tự như cao_su ) ; thường được gắn lên một đầu của bút_chì ; hành_động làm thứ gì đó sạch_sẽ ; đồ_dùng để tẩy cái gì đó ; làm cho sạch , tươi_sáng hoặc trong_suốt ; loại_bỏ những chất bẩn để làm sạch ; vứt bỏ cái gì đó trừu_tượng ; khiến cho trắng hơn hoặc sáng hơn ; làm sạch tạp_chất , tì_vết , ô_nhiễm , ... ; loại_bỏ màu ; loại_bỏ những thứ cặn_bã hoặc những gì không mong_muốn bằng hoá_chất và nước ; bỏ đi những thứ cặn_bã
cạn	đã sử_dụng hết ; kiệt nước ; không có chất_lỏng hoặc hơi ẩm ; thiếu độ_ẩm tự_nhiên hoặc bình_thường hay cạn_kiệt nước ; hoặc không còn ướt ; được dùng hết hoặc dùng sạch ; làm cho cạn ; ít hơn về mức_độ , cường_độ hay số_lượng ; bị đổ hết hay cạn_kiệt ( như nước hay các chất_lỏng khác ) ; không rơi nước_mắt ; hoạt_động hoặc sinh_sống hay phát_triển trên mặt_đất
cây_trồng	thực_vật được trồng trên quy_mô lớn với mục_đích thương_mại
đĩa_bay	vật_thể ( có_vẻ như ) bay mà người_ta không biết bản_chất ; nhất_là những vật_thể được coi là có nguồn_gốc ngoài Trái_đất
chỉnh_hình	[]
luồng	dòng_chảy hoặc sự thông khí mà không bị chặn ; số_lượng vật_thể nhỏ bay qua không_khí ; tiến_trình chi_phối của các sự_kiện hay những ý_tưởng liên_tiếp
màng_tế_bào	[]
bảng_tổng_sắp	danh_sách theo thứ_tự các điểm_số hay những kết_quả cho thấy những vị_trí tương_đối của những đối_thủ ( cá_nhân hay đội ) trong sự_kiện thể_thao
ngót_nghét	[]
xấp_xỉ	ước_lượng giá_trị ; đánh_giá sơ_bộ hay có sự ước_lượng về ( số_lượng hay thời_gian ) ; gần bằng về tính_chất hay giá_trị so với cái được so_sánh
biến_động	ở trong trạng_thái kích_động hoặc bị kích_động ; đem đến sự thay_đổi ( đặc_biệt là địa_vị xã_hội ) ; có sự lên xuống không_thể đoán trước ; nhiều sự_kiện hoặc biến_cố
cố_định	được gắn , đặt hoặc thiết_lập chặt ; vững_vàng trong vị_trí ; không lung_lay ; gắn chặt một_cách chắc_chắn và vững_chắc ; được quyết_định , giới_hạn hoặc định rõ một_cách chính_xác ; đặc_biệt được gắn_kết bởi luật_lệ hoặc bởi nguyên_nhân cụ_thể và sự bất_biến ; tiếp_tục hay tồn_tại mà không có sự thay_đổi nổi_bật về trạng_thái , điều_kiện hay vị_trí ; không có khả_năng thay_đổi
khuyết_điểm	nhược_điểm hoặc sự thiếu_sót ; điều còn thiếu_sót , không đầy_đủ trong tính_cách hay hành_động ; khiếm_khuyết hoặc điểm yếu trong tính_cách của một người ; dấu_hiệu hay khuyết_điểm trên bề_mặt của thứ gì đó ( đặc_biệt là trên thân_thể người ) ; trạng_thái hay sự thể_hiện của việc không hoàn_hảo ; tình_trạng còn có lỗi , chưa hoàn_hảo của một hệ_thống ; chỗ kém , chỗ yếu ; điều còn thiếu , còn có sai_sót hay điểm yếu
ưu_điểm	có đặc trứng là tính thế có lợi cho cạnh_tranh ; đặc_điểm , tính_chất vượt_trội đáng ngưỡng_mộ ; đặc_tính nổi_bật ; điểm xuất_sắc của điều gì đó hay ai đó
nhạo_báng	khinh_thường hoặc cư_xử với thái_độ khinh_miệt ; bắt_chước với lời giễu_cợt và chế_nhạo người khác ; bắt phải chịu sự cười_cợt hoặc sự chế_nhạo ; đối_xử hay nói_năng với sự coi_thường ; thể_hiện hoặc biểu_cảm của sự nhạo_báng , gây tổn_thương ; hành_động nhạo_báng hay chế_nhạo
khiếm_nhã	thiếu lễ_phép , không kính_trọng người khác , làm tổn_thương về tình_cảm hay những thứ khác ; thiếu vẻ yêu_kiều và thẩm_mĩ ; bất lịch_sự và thô_lỗ ; thiếu sự lịch_sự xã_hội ; cho thấy sự không có lịch_sự ; thô_lỗ ; thuộc về bản_chất của lời diễn_đạt xem_thường hoặc làm khó_chịu được thay_thế cho một lời diễn_đạt không làm mất_lòng ; ( người ) thiếu lịch_sự hay duyên_dáng ; thiếu sự tinh_tế , duyên_dáng hay tính thẩm_mĩ ; thể_hiện sự thiếu tôn_trọng , thô_lỗ ; không đúng khi thực_hiện hành_vi xã_hội ; thiếu lễ_độ , nhã_nhặn trong giao_tiếp , cư_xử
hại	có tính_chất gây tổn_thương cho sinh_vật sống ; có tính_chất gây hại hay có khả_năng gây hại ; gây ra hoặc tạo nên tác_hại ; dễ lây_nhiễm ; có khả_năng gây bệnh ; gây tổn_hại đến sức_khoẻ thể_chất hoặc tinh_thần ; thuộc về hoặc liên_quan đến hoặc bị gây ra do độc_tố hoặc thuốc_độc ; có_thể gây hại ; có hại cho sức_khoẻ ; cực_kì có hại ; có đặc_tính hoặc tác_dụng của chất_độc
lợi	mang lại lợi_ích ; có tính hữu_ích ; thứ gì đó khuyến_khích hoặc thúc_đẩy phúc_lợi ; đặc_điểm thuận_lợi của việc trở_nên hữu_ích
bướu_cổ	bệnh tuyến_giáp nở to , hình_thành bướu ở trước cổ
bệnh_tật	trạng_thái cơ_thể hoặc bộ_phận cơ_thể hoạt_động không được bình_thường ; gây ra bởi , biến_đổi do hay biểu_lộ bệnh hoặc bệnh_lí_học
cây_thuốc	cây thảo_mộc có tác_dụng chữa bệnh
cây_hoa_màu	[]
tinh_lọc	làm cho đặc hơn , mạnh hơn hoặc tinh_khiết hơn ; bỏ được tạp_chất nhờ xử_lí ; chuyển thành trạng_thái nguyên_chất , không bị pha_tạp , hoặc tinh_khiết ; tách_biệt với vật_chất không liên_quan hoặc làm sạch từ các tạp_chất ; loại_bỏ một thành_phần từ chất_lỏng
tinh_chế	loại_bỏ tạp_chất , tăng nồng_độ , và tách ra thông_qua quá_trình chưng_cất ; làm cho đặc hơn , mạnh hơn hoặc tinh_khiết hơn ; bỏ được tạp_chất nhờ xử_lí ; chuyển thành trạng_thái nguyên_chất , không bị pha_tạp , hoặc tinh_khiết ; tách_biệt với vật_chất không liên_quan hoặc làm sạch từ các tạp_chất ; xử_lí hoặc chế_biến để đặt vào điều_kiện có_thể sử_dụng
tăm_dạng	[]
tung_tích	[]
bức_bối	không dễ_chịu ; cảm_giác tức_giận vì một_vài điều khó_chịu phiền_phức ; có tính_chất chật_chội đến_nỗi có_thể làm ngạt ; làm thấy oán_giận hay giận_dữ
nguỵ_trang	hành_động che_giấu sự tồn_tại của cái gì đó bằng cách che_khuất diện_mạo của nó ; che_giấu bằng cách thay_đổi diện_mạo , vẻ bề_ngoài ; lợi_dụng vùng tự_nhiên xung_quanh để che_giấu thứ gì đó ; làm cho không_thể phát_hiện ra ; thay_đổi hình_dáng để làm cho không_thể nhận ra
thân_thể	tên gọi khác_nhau chỉ tập_hợp mọi bộ_phận trong một con_người ; cấu_trúc tổng_thể của một sinh_vật ( động_vật , thực_vật hoặc con_người ) ; liên_quan đến cơ_thể khi được tách_biệt ra khỏi trí_tuệ hay tinh_thần ; ảnh_hưởng hay đặc_thù của cơ_thể chứ không phải trí_óc hay tinh_thần ; con_người đang tồn_tại
đầu	trước tất_cả những thứ khác về thời_gian ; con vật_nuôi ; từ thông_tục ở Anh , chỉ cái đầu hoặc đầu_óc ; dạng tóc được chỉnh_trang ( đặc_biệt là tóc phụ_nữ ) ) ; đầu cùng của cái gì đó ; nhất_là của một thứ có mũi_nhọn ; vào lúc bắt_đầu hoặc gần lúc bắt_đầu của một khoảng thời_gian ; trước sự_kiện hoặc thời_điểm thường_lệ ; phần nhô ra của đồ_vật , có hình_dạng giống sừng ; một trong hai vị_trí đang liên_lạc với nhau ; yếu_tố đầu_tiên trong một chuỗi có_thể đếm được ; cụm dày_đặc của hoa hay cành lá ; có tính_chất xảy_ra ở lúc bắt_đầu ; có tính_chất tạo điều_kiện để bắt_đầu ; đầu_tiên trong thứ_tự sinh ; phần trên của cơ_thể con_người hoặc phần trước của cơ_thể động_vật ; bao_gồm khuôn_mặt và bộ_não ; trước tất_cả những thứ khác về thời_gian hay thứ_tự thực_hiện ; bộ_phận trên cùng của cơ_thể con_người , nơi có bộ_óc và nhiều giác_quan khác ; trước tất_cả những thứ khác trong thời_gian , không_gian hoặc mức_độ ; có tính_chất cần phải làm trước , tạo điều_kiện để thiết_lập các hoạt_động ; phần trước_nhất hoặc phần trên cùng của một_số vật ; một trong hai cực của một thứ có độ dài ; ở thứ_hạng trên tất_cả những người khác ; khối kết đặc và tròn ; người có trách_nhiệm ; phần phía trên của bất_kì cái gì ; phần nhô ra từ một đầu
thừa_thế	[]
hằn_học	thể_hiện mong_muốn đầy ác_ý và một ham_muốn gây hại ; có động_lực là lòng thù_hận
quỷ_quyệt	nổi_bật bởi mánh_khoé để lừa_bịp ; có ý_định lừa_phỉnh ; có đặc_trưng là sự lừa_gạt có chủ_ý , đặc_biệt bởi cách giả_bộ của cảm_xúc và hành_động theo cảm_xúc của người khác ; kín_đáo và bí_mật nhưng hèn_hạ
xảo_quyệt	nổi_bật bởi mánh_khoé để lừa_bịp ; có ý_định lừa_phỉnh ; được đặc_trưng bởi kĩ_năng trong việc đạt được kết_thúc như mong_muốn bằng mánh_khoé và xảo_quyệt ; có đặc_trưng là sự lừa_gạt có chủ_ý , đặc_biệt bởi cách giả_bộ của cảm_xúc và hành_động theo cảm_xúc của người khác ; đặc_tính của sự khéo_léo và lợi_dụng một_cách không lành_mạnh
hoang_phí	được đặc_trưng bởi sự lãng_phí và thừa_thãi ; tiêu_dùng quá mức ; tiêu_dùng của_cải một_cách lãng_phí ; chi một_cách thiếu suy_nghĩ ; ném bỏ đi ; có xu_hướng lãng_phí hay phí_phạm ; hành_động vô_ích hay không có lợi ; việc sử_dụng , tiêu_phí hoặc tiêu_thụ một_cách vô_ý_thức hay cẩu_thả ; tiêu ao một_cách thừa_thãi ; cũng được sử_dụng với danh_từ trừu_tượng
hà_tiện	keo_kiệt một_cách đáng xấu_hổ ; sống đạm_bạc và không sử_dụng nhiều tài_nguyên ; đưa hay tiêu_xài một_cách hạn_chế
cóp_nhặt	trữ lại để dùng trong tương_lai , để bán , dành cho một dịp hoặc một mục_đích đặc_biệt ; tập_hợp cùng nhau ; thu_thập hoặc nhóm lại với nhau ; cóp_nhặt ( tiền hoặc các tài_nguyên khác ) theo thời_gian
để_dành	dùng một_cách tằn_tiện hay cẩn_thận ; dự_trữ tiền để dùng trong tương_lai ; giữ lại hoặc để_dành , đặc_biệt là để dùng trong tương_lai hay khi có việc đột_xuất ; tìm chỗ cho và cất đi để dự_trữ ; giữ hoặc để_dành cho tương_lai sử_dụng ; cung_cấp hoặc trang_bị một lượng gì đó ; đưa hoặc phân_phát một nguồn tới một người hoặc một nguyên_nhân nào_đó ; dành cho_hay đề_xuất cho một mục_đích nào_đó
may	tháng trong năm , trước tháng Sáu và sau tháng Tư
rủi	dẫn đến đau_khổ hoặc vận đen ; có hay mang theo diều không may ; sự_việc không ngờ xảy đến và gây ra nhiều trở_ngại , khó_khăn cho ai hoặc hoạt_động gì đó
tum	[]
chân_vịt	rau có lá màu xanh thẫm , cây có hoa thuộc họ Dền , rất tốt cho sức_khoẻ ; thường nấu chín hoặc ăn sống ; đồ đi_ở chân khi bơi có phần trước trông giống mái_chèo để giúp bơi dễ_dàng hơn ( đặc_biệt là dưới nước sâu ) ; cây có hoa thuộc họ Dền , có nguồn_gốc Nam Á , lá có màu xanh ; thường được sử_dụng làm món ăn và làm_thuốc
nhạo	đối_xử hay nói_năng với sự coi_thường
vèo	di_chuyển với tốc_độ rất cao ; di_chuyển rất nhanh như bay ; di_chuyển có hoặc như có_tiếng rít
ngoại_lệ	[]
thường_lệ	xảy_ra , gặp phải , kinh_nghiệm hoặc được thấy thường_xuyên hay phù_hợp với thủ_tục thông_thường ; được sử_dụng hoặc thực_hành thường_xuyên ; thường_ngày ; phù_hợp với thói_quen hoặc thủ_tục thông_thường ; không lệch khỏi những gì thông_thường
phong_độ	khả_năng hoạt_động tốt ; hợp_thời trang và có sức hấp_dẫn tại thời_điểm đó ; thường khéo_léo và có sự hiểu_biết xã_hội
phong_thái	[]
biết_ơn	cảm_thấy hoặc thể_hiện sự biết_ơn ; thừa_nhận với sự biết_ơn ; biết_ơn ; bày_tỏ sự mang ơn , lời cảm_ơn hay sự biết_ơn ; thể_hiện lòng cảm_kích hoặc tỏ ra biết_ơn
vô_ơn	không thể_hiện sự biết_ơn hay không đếm_xỉa tới công_ơn của người đã có ơn đối_với mình
buồn_bã	trải qua hay thể_hiện nỗi_buồn hoặc sự bất_hạnh ; đi loanh_quanh chậm_chạp và không mục_đích ; về những điều mà khiến bạn cảm_thấy buồn ; bị hờ_hững , u_sầu , hay mê_muội ; biểu_hiện một trạng_thái rầu_rĩ ủ_ê ; thể_hiện sự buồn_phiền ; có tâm_trạng chán_nản , không vui , không hứng_thú với thứ gì vì vừa trải qua những việc đau_thương hoặc không như_ý ; có tính_chất khiến cho người khác cảm_thấy chán_nản ; làm cho không vui ; có tính_chất thể_hiện sự buồn_rầu hay gây ra sự buồn_rầu cho người khác
nối_tiếp	được ghi trong danh_mục để tiếp_tục cung_cấp dịch_vụ , như trong giao_thông vận_tải ; hành đông theo sau có trật_tự ; gần nhất về mức_độ hoặc thứ_tự ( không_gian hoặc thời_gian ) đặc_biệt là trong một chuỗi các nguyên_nhân và kết_quả ; rất gần về không_gian hoặc thời_gian
quay	thay_đổi hay chuyển_hướng ; thay_đổi hướng bằng chuyển_động ; quay ngoặt ; xoay ai đó hoặc vật gì đó ; quay bằng tay_quay ; di_chuyển bằng cách xoay hay quay tròn ; làm vật hoặc người chuyển_động bằng việc quay , theo vòng_tròn hoặc trên một trục ; làm cho những sợi tự_nhiên thành một sợi chỉ ; cuốn quanh theo hình xoắn_ốc ; làm ra một bộ phim hoặc thực_hiện một bức ảnh của cái gì đó ; đồ_chơi trẻ_con hình_nón thon tới đỉnh sắt mà nó có_thể được làm cho quay trên đó ; hướng sự chú_ý , sự quan_tâm , suy_nghĩ về phía cái gì hoặc ra khỏi cái gì ; di_chuyển như quay trên một trục ; được định_hướng ; khởi_động bằng cách quay ; việc quay hoặc xoay xung_quanh ( tại_chỗ ) ; di_chuyển xung_quanh một trục hoặc một tâm ; quay ra phía ngoài ; chuyển_động sang một hướng khác ; di_chuyển một góc nào_đó ; ghi lại bằng phim ; làm cho di_chuyển quanh một trục hoặc theo một hướng mới ; nấu bằng nhiệt khô , thường là trong một lò nướng ; làm cho chuyển_động xung_quanh hoặc xoay quanh ; hoàn_thành bằng việc quay ; điều_chỉnh cái gì bằng cách sử_dụng tay làm cho nút điều_khiển chuyển_động theo đường vòng ; thay_đổi phương_hướng , cũng dùng được với nghĩa trừu_tượng ; quay xung_quanh một cái trục hoặc điểm_tựa ; quay quanh trục của chính mình một_cách liên_tục
chuyển_hướng	sự thay_đổi hướng của một người khi đang di_chuyển ; chuyển ( tư_tưởng hay nguyên_tắc ) từ lĩnh_vực này sang lĩnh_vực khác ; đặt hoặc xếp vào một vị_trí xác_định khác ; ( hàng_hải ) hành_động thay_đổi đường chạy ; chuyển sang đường_ray khác , đối_với tàu_hỏa ; thay_đổi hướng chuyển_động của cái gì ; chuyển cái gì sang hướng khác ; hành_động thay_đổi hướng đã được đặt sẵn của cái gì ; làm cho chệch khỏi hướng trước đó hoặc hướng dự_định
tập_dượt	tham_gia tập đi tập lại cho thành_thạo
tập_luyện	giáo_dục bằng cách luyện_tập và nhắc_đi_nhắc_lại ; trải qua sự huấn_luyện quân_sự hoặc tập_luyện các bài_tập quân_sự ; tập_luyện để chuẩn_bị cho một sự_kiện hay cuộc thi_đấu ; thực_hiện việc rèn_luyện thể_chất
oxy_hoá	thêm oxy hoặc kết_hợp với oxy
đổi_thay	tạo nên sự thay_đổi , biến_đổi hay khác_biệt ; thay_đổi về hình_dáng hoặc đặc_tính mà không trở_thành cái khác ; bị làm cho hoặc trở_nên khác đi_về bản_chất hoặc hình_dáng ; thay_đổi về hình_thức hay đặc_điểm ; trở_nên khác_biệt mà không mất đi những đặc_trưng hoặc những thuộc_tính cốt_yếu ; trở_nên khác trước , đặc_biệt khi điều_kiện hay hoàn_cảnh khác trước
trà	loài cây thân bụi sống ở vùng nhiệt_đới như Trung_Quốc , Nhật_Bản ; lá và chồi được sử_dụng để sản_xuất trà ; cây_bụi hay cây thường xanh nhỏ có hoa đơn màu trắng , hồng hoặc đo_đỏ ; lá khô từ búp trà ; dùng để pha trà
bụi	khối nhỏ rời_rạc của vật_chất rắn hoặc lỏng mà vẫn còn phân_tán riêng_lẻ trong chất_khí hoặc lỏng ( thường được coi là một chất gây ô_nhiễm không_khí ) ; thực_vật thân gỗ , mọc thấp , thường có một_vài thân chính ; tiếng_lóng của cô - ca-in ; dạng hạt nhỏ mịn như bột ; thảm_thực_vật dày_đặc gồm những cây_thân_gỗ thấp nhỏ hoặc cây_bụi ; khu mọc dày_đặc cây ; hạt cực nhỏ di_chuyển tự_do của vật_liệu rắn ; vật_chất dạng bột mịn như đất khô hoặc phấn hoa có_thể được cuốn đi trong không_khí
phỏng	cảm_thấy nóng như đặt trên lửa ; không hoàn_hảo
mảnh	mảnh nhỏ của một thứ rơi ra từ chỉnh_thể ; rất hẹp ; bộ_phận hoặc phần ghép lại với bộ_phận khác để tạo thành thể hoàn_chỉnh ; miếng gỗ hoặc miếng kim_loại mỏng ; mẩu nhỏ hoặc lượng nhỏ ; mỏng về chiều dày hoặc đường_kính ; mỏng và kém độ bền chắc , kém sức chịu động trước những tác_động từ bên ngoài ; phần nhỏ được cắt ra từ một phần_lớn hơn ; phần được tách rời khỏi phần chính của cái gì đó ; phần không trọn_vẹn ; ( phi kĩ_thuật ) mẩu rất nhỏ của bất_cứ thứ gì ; đồ nhân_tạo gồm một mẩu dẹt và hẹp ; phần của một vật_thể tự_nhiên ; khu_vực gồm những phần đất được chia nhỏ ; miếng rời ra hoặc được cắt rời khỏi một thứ khác
phòng_ngủ	phòng được sử_dụng chủ_yếu để ngủ
công_trình_phụ	phòng hay nhà được trang_bị bồn_cầu
hình_hoạ	[]
cung_bậc	[]
hoạ	điều không may và tai_hại gây ra tổn_thất , những chấn_động tâm_lí ; tạo nên một bức tranh của ; tạo nên một bức tranh ; tình_trạng của những điều bất_lợi ( nguy_hiểm , tai_hoạ hay lúc khó_khăn ) ; thứ gì đó gây ra sự đau_khổ hay cái chết ; sự_kiện gây ra sự đau_khổ và tình_cảnh khốn_cùng ; thứ gây thiệt_hại , phá_huỷ hoặc đem đến bất_hạnh ; hành_động dẫn đến những hậu_quả tai hai
phúc	rất được ưa_chuộng hoặc có nhiều may_mắn
nửa_mùa	[]
đồng_điệu	[]
thịnh_hành	thường_xuyên hoặc phổ_biến nhất
hữu_tình	[]
biệt_ly	[]
sum_họp	[]
phụ_bản	[]
nếp_tẻ	[]
lời_lãi	khoản tiền mà doanh_thu của một doanh_nghiệp vượt quá chí phi hoạt_động của doanh_nghiệp
thua_lỗ	không tạo ra tiền trong kinh_doanh ; bị thua_lỗ hoặc không tạo ra lợi_nhuận ; không kiếm được tiền trong kinh_doanh ; bị thua_lỗ hoặc không tạo ra lợi_nhuận
con_đường	cách_thức hay biện_pháp đạt được điều gì ; vật_thể được con_người làm ra để di_chuyển từ nơi này đến_nơi khác ; khoảng không_gian mở ( thường dùng chung ) phục_vụ việc đi_lại hay vận_chuyển ; đường đi hoặc đường vào được thiết_lập
vỉa_hè	phần mép hai bên đường có tác_dụng bảo_vệ mặt_đường , thường dành cho người đi bộ ; phần dọc theo hai bên đường_phố , thường được lát gạch chuyên_dùng , dành riêng cho người đi bộ ; thường nằm ngay sát lòng_đường ; phần mép hai bên đường tác_dụng bảo_vệ mặt_đường , thường dành cho người đi bộ
chính_nghĩa	[]
phi_nghĩa	giành được một_cách bất_hợp_pháp hay bằng những thủ_đoạn bất_chính ; không đủ lí_lẽ thuyết_phục
trần_gian	thuộc về trái_đất ; nơi cư_trú của con_người trên mặt_đất ( trong đối_lập với Thiên_Đường hay Địa_Ngục ) ; những lo_lắng về cuộc_đời này , khác_biệt với thiên_đàng và cái đến sau cái chết
cõi_âm	nơi mình đến ở sau khi chết
vượng	[]
suy	trải qua một cuộc suy_thoái đột_ngột và trầm_trọng
lắng_nghe	nghe và dành sự chú_ý ; nghe có chủ_định ; hành_động nghe một_cách chăm_chú ; để tâm_trí vào ; nghe một_cách im_lặng mà không đóng_góp gì vào_cuộc nói_chuyện ; chú_ý kĩ tới ; để_ý kĩ tới
lắng_tai	để tâm_trí vào ; chú_ý kĩ tới ; để_ý kĩ tới
ấp_úng	nói thể_hiện sự do_dự trong lựa_chọn , quyết_định ; phát ra tiếng ^ e_hèm ^ và tiếng ^ ậm_ừ ^ , thể_hiện sự ngập_ngừng
nói	sử_dụng ngôn_ngữ ; thuật lại hoặc cung_cấp lại một_cách chi_tiết về ; thông_tin một_cách xác_thực với vẻ chắc_chắn và tự_tin ; trao_đổi những suy_nghĩ ; nói_chuyện với ; có khả_năng hoặc liên_quan đến lời_nói hoặc việc nói ; diễn_tả thông_qua lời_nói ; thể_hiện bằng lời ; nói ra một lời phát_biểu ; làm cho nghe được ; bày_tỏ bằng lời_nói ; thể_hiện ra ; có_thể bằng lời_nói hoặc bằng những tiếng khóc , tiếng gào , hét ; truyền thông_tin ; làm lộ những thông_tin hoặc bí_mật quan_trọng , tạo được sự tin_cậy cho mọi người ; nói ra những đơn_vị âm_thanh có_nghĩa ; thể_hiện bằng lời_nói ; được nêu ra qua lời_nói hay được đặc_trưng bởi lời_nói
thất_bại	mất quyền_lực ; đặc_biệt là không thành_công trong bầu_cử hay thi_đấu ; không thành_công ; không chiến_thắng trong cuộc tranh_đấu hay cuộc đọ sức giữa các bên ; không thành_công ; thất_bại hay có một kết_quả không thuận_lợi ; bị đánh_bại ; hành_động thất_bại ; không được gì hoặc không thắng ai đó ; hỏng hoàn_toàn ; sụp_đổ
thành_công	đạt tới thành_công hoặc đạt tới mục_tiêu mong_muốn ; thành_công lớn ; đạt đến đỉnh_cao ; thành_công ; đạt được mục_tiêu ; có kết_quả như dự_định hoặc được đánh_dấu bằng một kết_quả thuận_lợi ; đạt được thành_công ; đạt được mục_đích hay mục_tiêu ; hoàn_thành nhiệm_vụ một_cách thành_công ; rõ_rệt bởi sự bình_yên và thịnh_vượng ; tình_trạng thành_công về mặt tài_chính ; việc đạt được mục_tiêu đã đề ra
đa_ngôn	[]
mỏng_tang	rất mỏng ; mỏng đến mức ánh_sáng có_thể xuyên qua
ái_mộ	cảm_thấy kính_phục và yêu_mến
hâm_mộ	nhìn với sự ngưỡng_mộ ; coi như đối_tượng được yêu_thích , ủng_hộ ; cảm_thấy kính_phục và yêu_mến
tí_ti	lượng nhỏ nhưng đủ dùng
tí_teo	[]
nỗi_đau	tình_huống thê_thảm hoặc gây phiền_muộn ; cảm_xúc buồn khổ ; cảm_giác mà mọi người đều cố_gắng tránh
tai_hoạ	điều không may và tai_hại gây ra tổn_thất , những chấn_động tâm_lí ; tình_trạng của những điều bất_lợi ( nguy_hiểm , tai_hoạ hay lúc khó_khăn ) ; tình_trạng bị huỷ_hoại nặng ( thường là khó khắc_phục ) và bất_hạnh ; thứ gì đó gây ra sự đau_khổ hay cái chết ; sự_kiện gây ra sự đau_khổ và tình_cảnh khốn_cùng ; thứ gây thiệt_hại , phá_huỷ hoặc đem đến bất_hạnh
dương_gian	thuộc về trái_đất ; nơi cư_trú của con_người trên mặt_đất ( trong đối_lập với Thiên_Đường hay Địa_Ngục ) ; những lo_lắng về cuộc_đời này , khác_biệt với thiên_đàng và cái đến sau cái chết
cõi_âm	nơi mình đến ở sau khi chết
phân_tử	( vật_lí và hoá_học ) đơn_vị cấu_trúc đơn_giản nhất của một nguyên_tố hay hợp_chất
nếp_tẻ	[]
định_kỳ	xảy_ra hoặc tái_diễn vào mỗi khoảng thời_gian nhất_định
bất_thường	không bình_thường , ví_dụ , về trí thông mình hoặc mức_độ phát_triển ; khác_biệt rõ_rệt từ một quy_chuẩn được chấp_nhận ; vượt lên khỏi những gì bình_thường hay tầm_thường ; rất đặc_biệt hay rất đáng chú_ý ; có khả_năng thay_đổi thường_xuyên không có lí_do rõ_ràng hoặc có sức thuyết_phục ; biến_số ; không phổ_biến hoặc không thường_xuyên bắt_gặp ; thường có số_lượng lớn hoặc nổi_bật về tính_cách hay chủng_loại ; không có quá_trình cố_định ; lệch khỏi mong_đợi thông_thường ; xảy_ra từng thời_điểm ; không xảy_ra với tốc_độ đều_đặn hoặc khoảng thời_gian cố_định ; không tuân theo những quy_luật khoa_học ; sự thay_đổi đột_ngột không_thể đoán trước ; biến_đổi và diễn ra_vào các khoảng thời_gian không đều ; không bình_thường ; không tiêu_biểu , bình_thường , theo trình_tự hoặc tuân theo một chuẩn ; chưa từng xảy_ra trước_đây
trước	mặt ở phía trước hay nhô ra ; vừa_qua ; ( dùng cho người ) đã từng nắm giữ chức_vụ ; gần đây nhất ; thuộc về thời_gian trước ; ở , gần hoặc hướng tới phía trước ; thuộc về thời đã qua , đã rất lâu rồi ; đã trôi qua ; thuộc về quá_khứ ; trước thời_hạn hoặc nhu_cầu cần_thiết ; đến trước về thời_gian hay thứ_tự ; liên_quan đến hoặc được đặt ở đằng trước ; sớm hơn về thời_gian ; tồn_tại trước hay đến trước ; thuộc hoặc gần cuối đầu hay hướng đến mặt trước của cơ_thể
sau	đến sau hay theo sau ; liên_quan đến hoặc được đặt ở đằng sau ; ở giai_đoạn sau của quá_trình phát_triển ; được đặt ở phía sau hoặc hướng về phía sau ; ở hay hướng theo thời_kì hoặc giai_đoạn sau của sự phát_triển ; nói đến người hoặc vật thứ_hai trong hai người hoặc hai vật được đề_cập đến ( hoặc người hay vật sau ) ; chưa xảy_ra hay chưa đến ; có tính_chất tiếp_nối , theo sau về mặt thời_gian hoặc trình_tự
đánh_bóng	làm cho bề_mặt một vật nào_đó sáng bóng ; làm sạch với một miếng bọt_biển , bằng cách cọ_xát ; hành_động đánh_quả bóng quần_vợt bằng chiếc vợt quần_vợt ; đánh_bóng và làm sáng bóng ; nâng_cấp hoặc làm cho hoàn_hảo nhờ tỉa_tót hoặc đánh_bóng ; tạo độ bóng cho cái gì , đặc_biệt bằng cách chà_xát ; vung gậy gôn vào quả bóng và đánh mạnh vào nó ; làm thứ gì nhẵn và sáng bằng cách lau_chùi hoặc chà sát ; tô màu bằng các đường sọc , vết có độ sáng tối khác_nhau ; hành_động vung bóng hay đánh_bóng bằng gậy gôn , vợt , gậy bóng_chày , cây cơ hoặc tay
làm_đẹp	trở_nên đẹp hơn để ngắm ; làm cho đẹp hơn
đoán	đoán trước hoặc tiết_lộ bằng , hoặc như_thể bằng linh_cảm hoặc bằng năng_lượng thần_bí mang tính siêu_nhiên ; trông_mong , tin_tưởng , hoặc phỏng_đoán ; suy ra từ bằng_chứng không đầy_đủ ; tin rằng như_vậy ; đưa ra một dự_đoán cho_dù có khả_năng bị bác_bỏ ; đoán một_cách chính_xác ; tìm ra hướng giải_quyết bằng cách phỏng_đoán ; cố_gắng thử đoán trước ; ước_lượng giá_trị ; đánh_giá sơ_bộ hay có sự ước_lượng về ( số_lượng hay thời_gian ) ; tin rằng , đặc_biệt là dựa trên những cơ_sở không chắc_chắn hay không quả_quyết ; biết hoặc nắm_bắt bằng trực_giác hoặc cảm_giác ; đoán trước nhờ hoặc như_thể nhờ khả_năng tiên_tri ; nhận thấy nhờ trực_giác hoặc qua khả_năng cảm_nhận không_thể giải_thích ; đoán trước tình_hình , sự_việc có_thể xảy_ra ; phỏng_đoán cái gì đó và không có cơ_sở chắc_chắn ; cho là có_thể ; báo trước về sự_kiện nào_đó như sự can_thiệp siêu_nhiên ; hành_động đưa ra những nhận_định về tương_lai ( bằng cách suy_luận về tương_lai )
quan_sát	nhìn chăm_chú ; nhìn một_cách chăm_chú ; theo_dõi bằng mắt hoặc bằng tâm_trí ; theo_dõi hoặc xem ; chý ý quan_sát từng hoạt_động , diễn_biến để nắm rõ được để kịp_thời ứng_phó và xử_lí ; nhận thấy bằng thị_giác hay có năng_lực để nhận thấy bằng thị_giác ; hành_động xem hay nhìn ; kiểm_tra cẩn_thận ( con vật bị săn trong rừng ) bằng ống_nhòm ; xác_định vị_trí ( một vật_thể chuyển_động ) bằng một hệ_thống theo_dõi như ra đa ; trở_nên nhận_biết được thông_qua các giác_quan ; quan_sát hoặc xác_định bằng vẻ mặt
đồ_dùng	đồ do con_người tạo ra ; hàng_hoá có tính bền được sử_dụng trong gia_đình hay văn_phòng ; dụng_cụ sử_dụng hàng ngày ; vật_dụng được thiết_kế để thực_hiện một_số chức_năng cụ_thể , phục_vụ một_số hoạt_động nhất_định ; cái được tạo ra để phục_vụ một mục_đích nào_đó
đồ_vật	vật_thể hiện_hữu và cụ_thể , vật_thể có_thể tạo ra bóng đổ ; đồ do con_người tạo ra ; vật_thể nhân_tạo nói_chung
giải_tán	kết_thúc sự hợp_tác hay đưa đến sự tan_vỡ ; không còn tụ_họp thành đám , xa_rời nhau nhau ; tách rời thành các phần hoặc mất đi sự kết_dính hay sự thống_nhất ; không còn tụ_tập , tham_gia vào một nhóm ; mỗi thành_viên tách ra hoạt_động riêng ; không_thể tiếp_tục tồn_tại hoặc duy_trì , đi đến sự kết_thúc một quá_trình , một sự_nghiệp , một mối quan_hệ . . ; ngừng hoạt_động hoặc ngừng gắn_kết như một khối ; tuyên_bố không có hiệu_lực
tập_hợp	tập_hợp ở một nơi nào_đó ; gọi thực_hiện nhiệm_vụ , phục_vụ quân_đội , thực_hiện nghĩa_vụ bồi_thẩm , … ; tập_hợp hay mang lại cùng nhau ; lập thành một nhóm hay nhóm các thành_viên đơn_lẻ lại với nhau ; tạo nên sự tích_luỹ ; tập_hợp cùng nhau ; đi cùng nhau , thường có mục_đích ; đưa mọi người lại với nhau ; mời hoặc ra_lệnh để gặp_mặt ; tập_hợp ; nhóm các vật lại với nhau ; gọi cùng một lúc ; kêu_gọi các quân_chủng thuộc các đơn_vị tham_gia ; đứng vào vị_trí để tạo thành đội_hình hay hàng ; tập_hợp lại vì một mục_đích , hoạt_động hay sự_nghiệp chung , hoặc trong cùng một hoàn_cảnh ; thành_lập một uỷ_ban hay một cơ_quan pháp_luật bằng những người ủng_hộ mình để làm ảnh_hưởng tới kết_quả ; tạo nên toàn_bộ hay tổng_thể ; tụ_tập ở một nơi ; mớ phức_tạp những thứ cùng tồn_tại ; tìm_kiếm và thu_gom cùng nhau ; tập_hợp đóng , mang tính liên_kết , có một đồng_nhất thức và mỗi phần_tử đều có nghịch_đảo ; tụ_họp nhau lại thành đám đông ; ( toán_học ) một tập_hợp trừu_tượng gồm các con_số và biểu_tượng ; tập_hợp thứ gì lại với nhau ; kết_hợp với nhau thành một nhóm hoặc tập_hợp hay hình_thành một nhóm ; vật được nhóm lại với nhau hoặc được coi như một tổng_thể
nhóm	việc đặt các thứ vào cùng nhóm ; sáng_tạo bằng cách nhóm các thành_phần hoặc thành_viên lại với nhau ; nhóm hoạt_động phi_pháp ở những địa_bàn nhất_định ( nói khái_quát ) ; số_lượng các thực_thể được coi như một đơn_vị ; tập_hợp những thứ liên_quan để sử_dụng cùng nhau ; tập_hợp những người hoặc những thứ xuất_hiện cùng nhau ; tổ_chức được coi như một phần của nhóm xã_hội lớn hơn ; ( hoá_học ) hai hay nhiều nguyên_tử liên_kết với nhau như một đơn_vị duy_nhất và tạo thành một phần của phân_tử ; nhóm người hoặc vật có liên_kết chặt_chẽ với nhau ; nhóm người có liên_quan với nhau bởi một_số mối ràng_buộc hoặc công_việc chung và được coi là một thực_thể ; nhóm người tham_gia vào một hoạt_động chung ; tập_hợp những người đại_diện cho một_vài nhóm lớn hơn ; nhóm bạn_bè thân_mật ; tập_hợp đặc_biệt những người nổi_tiếng ; lập thành một nhóm hay nhóm các thành_viên đơn_lẻ lại với nhau ; đơn_vị hợp_tác ( đặc_biệt là trong thể_thao ) ; nhóm lao_động có tổ_chức ; tổ_chức tự thành_lập để thúc_đẩy , phát_triển cái gì ; nhóm người kết_nối với nhau để cùng thực_hiện một mục_đích chung , trong sự đối_lập với những nhóm người khác ; thu_nhặt và đốt vật_liệu ; nhóm người Cơ đốc có đức_tin và các hình_thức thờ phượng riêng ; ( sinh_học ) nhóm các sinh_vật tạo thành một nhánh của một bộ_phận lớn hơn ; tổ_chức của những người hay tài_nguyên có_thể chia_sẻ được
liên_kết	thành_lập một liên_kết hoá_học với ; tạo ra mối quan_hệ logic hay nhân_quả ; liên_lạc với các thành_viên và trong phạm_vi một nhóm ; thêm vào từ một nguồn khác ; hành_động gắn_kết nhiều thứ lại để hình_thành tổng_thể mới ; hành_động kết_giao hay tham_gia với những người khác ; trở_thành bạn đồng_minh hoặc cộng_sự , như theo một thoả_thuận hay sự gắn_kết ; có tính_chất tham_gia và kết lại với nhau ; của một hợp_chất hữu_cơ ; có chứa hai hoặc nhiều liên_kết đôi , mỗi liên_kết đôi cách nhau bằng một liên_kết đơn ; liên_kết hoặc kết_hợp ; tham_gia vào sự liên_kết hay hoạt_động ; nắm giữ được phần_tử , chất_liệu hay vật_liệu khác trong liên_kết hoá_học hay vật_lí ; gắn_kết với nhau đặc_biệt trong cặp hay trong nhóm ; được đặc_trưng bởi sự thống_nhất ; tham_gia vào một thực_thể duy_nhất ; thiết_lập một quan_hệ hay một mối quan_hệ ; hành_động phối_hợp hay liên_kết trong một mục_đích hay niềm_tin chung ; tham_gia vì mục_đích chung hay trong sự hoạt_động chung ; đem hai vật nối lại với nhau ; đưa vào một quan_hệ chung , bổ_sung hoặc tương_hỗ ; cung_cấp cho đối_tác ; kết_hợp lại cùng một mục_đích chung ; ở trong sự kết_hợp hay hành_động kết_hợp với ; làm cho các thành_tố rời_rạc kết_nối hoặc liên_kết với nhau ; có gắn với nhau ; tạo thành một tập_đoàn ; hành_động như một người cộng_sự ; có tính_chất kết_hợp từ hai thứ trở_lên
đầu_tiên	trước tất_cả những thứ khác về thời_gian ; yếu_tố đầu_tiên trong một chuỗi có_thể đếm được ; ( thông_tin ) không phải gián_tiếp hay thông_qua trung_gian ; có tính_chất xảy_ra ở lúc bắt_đầu ; có tính_chất tạo điều_kiện để bắt_đầu ; trước tất_cả những thứ khác về thời_gian hay thứ_tự thực_hiện ; trước tất_cả những thứ khác trong thời_gian , không_gian hoặc mức_độ ; có tính_chất cần phải làm trước , tạo điều_kiện để thiết_lập các hoạt_động
cuối_cùng	yếu_tố cuối_cùng hoặc mang tính quyết_định trong một chuỗi ; nằm ở đầu_cuối ; phần ở cuối hoặc thấp nhất trong một trật_tự hoặc một chuỗi ; cao nhất về phạm_vi hay mức_độ ; tạo thành_phần cuối hoặc kết_thúc ; tạo ra sự kết_thúc đối_với những nghi_ngờ hoặc nghi_vấn ; nằm ở dưới cùng hoặc vị_trí thấp nhất ; mang tính kết_luận trong một quá_trình hoặc tiến_trình ; có ý_nghĩa quan_trọng mang tính kết_luận cuối_cùng ; cuối_cùng hoặc kết_thúc ; cuối_cùng trong cuộc_đời của ai đó ; thời_điểm cái gì đó kết_thúc
hảo_hữu	người mà bạn biết rõ , yêu_mến và tin_tưởng
người_thân	người có mối quan_hệ huyết thông hoặc hôn_nhân ; ( thường ở dạng số_nhiều ) người có tầm ảnh_hưởng mà mình quen_biết ( quan_hệ gia_đình hoặc bè_bạn )
quyển	vật gồm những trang giấy đóng lại với nhau ; một trong các ấn_phẩm giống nhau
bìa	lớp phủ bên ngoài bảo_vệ mặt trước , mặt sau và gáy của cuốn sách
vượt_tuyến	[]
hằn_học	thể_hiện mong_muốn đầy ác_ý và một ham_muốn gây hại ; có động_lực là lòng thù_hận
chiến_bại	[]
thắng_lợi	đã chiến_thắng ; chiến_thắng ( trong một cuộc đua hay cuộc_thi khác ) ; có kết_quả như dự_định hoặc được đánh_dấu bằng một kết_quả thuận_lợi ; việc đạt được mục_tiêu đã đề ra
bành_tô	[]
khăn	vật được làm ra để quấn quanh cổ ; phụ_kiện quần_áo được đeo trên cổ ; mảnh vải thấm hình_chữ_nhật ( hoặc giấy ) dùng để lau hay làm sạch ; đồ quấn quanh đầu , cổ hoặc vai để giữ ấm hay trang_trí
đỡ_đần	[]
bình_luận	đánh_giá có tính bình_luận , phân_tích ; đánh_giá hoặc phê_bình thứ gì đó với sự nhận_biết sau ; thực_hiện hoặc viết lời bình_luận về cái gì ; thêm lời bình , tiêu_đề chẳng_hạn cho một bộ phim
hạ	hạ thấp độ cao ( của nốt_nhạc ) ; hạ xuống ; hành_động làm cái gì trở_nên ít hơn ; đến hoặc dừng lại ở địa_điểm nào_đó để nghỉ_ngơi ; thuộc về hoặc có đặc_trưng hay diễn ra_vào mùa_hè ; bị làm cho nhỏ hơn về kích_cỡ , số_lượng hoặc mức_độ ; hành_động hạ cái gì ( như cây ) ; loại_bỏ ; giảm giá_trị ước_lượng của cái gì đó ; mùa nóng nhất của năm , tính_từ hạ_chí đén thu_phân ; ở bán_cầu Bắc ; đặt ở mức thấp hơn ; làm cho bị ngã bằng hoặc như bằng việc giáng cho một cú ; hạ thấp thứ_bậc hoặc buộc ai ở vào một tình_thế nhục_nhã ; giảm đi_về kích_thước , chừng_mực hoặc phạm_vi ; làm cho ít phức_tạp hơn ; vươn lên khỏi nghịch_cảnh , khắc_phục khuyết_điểm để giành được thắng_lợi ; hành_động làm giảm đi hay giảm bớt cái gì đó ; có_vẻ như đang đi xuống ; giảm trọng_lượng ; thấp hơn nhiều so với thông_thường ( đặc_biệt là giá_cả )
tăng	nhà nhỏ di_động ( thường bằng vải bạt kéo căng trên các cột đỡ và buộc chặt xuống đất bằng dây thừng và chốt chặt ; nâng cao ; tăng lên về mặt giá_trị hoặc tăng đến mức cao hơn ; tăng kích_thước , độ lớn , số_lượng hoặc cường_độ ; tăng lên ; tiến_bộ hoặc tăng ; làm tăng hoặc tăng ; tăng hoặc phát_triển ; phát_triển hoặc tăng_cường ; tăng tỉ_lệ hoặc giá_thành ; tăng lên ; tăng ( trọng_lượng cơ_thể ) ; trở_nên lớn hơn về lượng ; khiến cho lớn hơn hoặc nhiều hơn
tợn	[]
hiền	hiền_hoà và tốt_đẹp trong bản_chất hay ảnh_hưởng ; rất ngoan_ngoãn ; có tính_cách cởi_mở và vui_vẻ
bội_bạc	có đặc_tính hoặc đặc_điểm của một kẻ phản_bội ; không thể_hiện sự biết_ơn hay không đếm_xỉa tới công_ơn của người đã có ơn đối_với mình ; đối_xử không tốt ; không trung_thành với người bạn_đời hoặc người_yêu
chung_thuỷ	kiên_định trong tình_cảm hay lòng trung_thành ; không có quan_hệ tình_dục với bất_cứ ai ngoại_trừ chồng hoặc vợ , bạn_trai hoặc bạn_gái ; kiên_định với mục_đích , sự tận_tâm hay tình_cảm
nhà_máy	toà nhà cho việc lao_động công_nghiệp ; nhà_máy gồm một hay nhiều toà nhà với các thiết_bị phục_vụ cho việc sản_xuất
dây_chuyền	đồ trang_sức là một vòng dây ( thường mang đá_quý ) được đeo quanh cổ như một đồ trang_trí ( đặc_biệt ở phụ_nữ ) ; hệ_thống cơ_khí của nhà_máy nhờ đó một vật được chuyển qua các địa_điểm mà ở đó những hoạt_động nối_tiếp sẽ được thực_hiện ; dây gồm nhiều vòng nhỏ bằng kim_loại móc_nối vào nhau , thường dùng làm đồ trang_sức ; đồ trang_sức đeo ở cổ ( mảnh lông thú hay chuỗi hạt )
tàu_hoả	phương_tiện giao_thông công_cộng được trang_bị đường_ray xe_lửa ghép thành đôi với nhau và được kéo đi bởi một đầu_máy
xe_điện_ngầm	[]
thuở	[]
thủa	[]
tranh	đề_cử , ra ứng_cử hoặc cạnh_tranh cho một vị_trí hoặc chức_vụ ; tác_phẩm hội_hoạ phản_ánh hiện_thực bằng đường_nét và màu_sắc ; có được một_cách rất nhanh và bất_ngờ ; thực_hiện những sự cạnh_tranh trong một cuộc đua ; chiến_đấu hoặc đấu_tranh chống lại trong một trận đánh hoặc hình_thức giống như ở trong một trận đánh
trông_nom	chăm_nom cho mong_muốn và nhu_cầu của người khác ; cung_cấp sự chăm_nom cho ; quản_lí hoặc trông_nom việc_gì ; canh_chừng giống một người chăm_nom , như một giáo_viên hướng_dẫn học_sinh ; giám_sát và hướng_dẫn ; chịu trách_nhiệm về việc trông_coi và giữ_gìn theo những yêu_cầu nhất_định ; trông_nom hoặc săn_sóc ; làm_việc với tư_cách người_quản_lí ; giám_sát hoặc chịu trách_nhiệm về cái gì đó ; là người trông_coi , chịu trách_nhiệm về việc_gì đó ; trông_chừng ; phục_vụ như một y_tá ; chăm_sóc người bị bệnh hay những người tàn_tật
cây_thân_gỗ	thực_vật có các mô hoá gỗ hay các bộ_phận dạng gỗ , đặc_biệt là thân ; loại thực_vật thân gỗ cao , lâu năm , có thân chính và các cành tạo nên tán ngọn nâng cao và tách_biệt ; bao_gồm cả loài hạt_trần và hạt_kín
cành	phần tách ra khỏi thân hoặc mọc ra từ thân ; cành trên các cành chính mọc ra từ thân hay chạc cây ; phần của hình được phân_chia thành các nhánh
xuôi	di_chuyển một_cách êm_ả dọc theo một bề_mặt
ngược	được dùng cho mặt của một tấm vải hay quần_áo có khuynh_hướng hướng vào bên trong ; cho thấy sự đối_lập hoặc đối_kháng ; ở vị_trí mà đỉnh và đáy đảo_ngược nhau ; theo hướng ngược với dòng_chảy ; đảo_ngược ( quay ngược_lại ) về trật_tự , bản_chất , hoặc tác_dụng ; trái hẳn lại về bản_chất , tính_cách hay mục_đích ; ( cú đánh vợt ) được thực_hiện ngang qua cơ_thể với mu bàn_tay quay về hướng của cú đánh ; di_chuyển , hướng theo hoặc có xu_hướng theo hướng phía sau hoặc đối_lập với một hướng trước đó ; hoàn_toàn khác_nhau về bản_chất , chất_lượng hoặc tầm quan_trọng ; được đặc_trưng bởi sự đối_kháng hay ác_cảm ; di_chuyển hoặc đối nhau ở khoảng_cách xa ; theo cách trái_lại với bình_thường
biên_nhận	loại giấy_tờ hợp_lệ chứng_minh sự trả nợ xong hay hoàn_thành nghĩa_vụ
móc	dùng chân để lấy ; làm công_việc may_vá bằng kim_móc ; tạo ra cái gì đó bằng cách dùng kim_móc hoặc lồng vào ; vật mà trong đó một thứ gì đó có_thể treo lên ; quào , cào , móc , hay đào bằng vuốt hoặc móng ; dụng_cụ gồm một hoặc vài cái móc để móc hoặc giữ , được buộc với dây thừng để giữ tàu , thuyền ; bị mắc hoặc vướng vào ; siết chặt bằng móc , chốt hay khoá ; đan bằng mũi đan móc ; thiết_bị cơ_khí được uốn cong để móc , treo hay kéo cái gì đó ; ăn_cắp ; vật có hình_dáng cong hoặc được gập xuống dùng để treo hay kéo cái gì đó ; loại_bỏ , gặt_hái , hoặc giành lại bằng cách khai_quật ; được đặt vào vị_trí , như bằng bản_lề ; làm cho treo lên hay làm cho lơ_lửng ; cả dấu \ mởngoặcvuông \ đóngngoặcvuông lẫn \ mởngoặc \ đóngngoặc dùng để bao một phần văn_bản ; vật dùng để cài hoặc giữ cửa chính hay cửa_sổ
thi_hành	đảm_bảo sự tuân_thủ luật_lệ và phép_tắc ; tiến_hành hoặc thực_hiện ; như công_việc hay nghề_nghiệp ; làm nhiệm_vụ gắn với chức_năng , địa_vị và quyền_hạn được giao_phó ; áp_dụng hoặc làm cho thành có hiệu_lực điều đã được chính_thức quyết_định ; hành_động thực_hiện ; tạo ra kết_quả ; xử_lí có hiệu_quả ; tuân theo hành_động hoặc thực_hiện theo ; làm cho có tính hợp_pháp của ; hành_động thực_hiện ; làm việc_gì đó thành_công ; sử_dụng tri_thức phân_biệt với việc chỉ sở_hữu nó một_cách đơn_thuần
bắt	cầu_thủ có nhiệm_vụ bắt bóng ; bắt hoặc khiến ai đó hoặc cái gì đó phải hành_xử theo một_cách nào_đó ; làm cho phải tham_gia hay không tham_gia vào một hành_động hoặc phải rơi vào hay phải ra khỏi một một trạng_thái , theo cả nghĩa_đen hoặc nghĩa_bóng ; nắm lấy một_cách vội_vàng hay háo_hức ; di_chuyển bằng một phương_tiện giao_thông , hoặc theo một tuyến đường nhất_định ; kèm cầu_thủ chạy về gôn để loại cầu_thủ đó ; bắt phải làm dưới sức_ép hay ép_buộc về mặt tinh_thần , thể_chất hay đạo_đức ; dùng vũ_lực nhằm bắt_giữ ; tác_động , thậm_chí ép_buộc khiến người nào làm việc_gì ; làm một_cách mạnh_mẽ ; sử_dụng lực ; khiến cho trải qua hay chịu_đựng hoặc làm cho đau_khổ hay bị tổn_thương ; hành_động bắt người bằng vũ_lực ; thực_hiện những cử_động giành lấy một_cách vội_vã ; tận_dụng hoặc chấp_nhận vì lí_do nào_đó ; làm cho ( ai đó ) phải chịu_đựng điều gì đó ; bắt một vật bằng tay ; giữ lại để tịch_thu hoặc chặn lại hay cản_trở chuyển_động của ; bắt một_cách bất_ngờ ; thúc_đẩy hoặc bắt_buộc ( một người ) phải hành_động ; ép_buộc hoặc thúc_đẩy ; chỉ_dẫn hay dùng bằng quyền_lực ra_lệnh ; bắt vào nhà_giam ; đưa ra chỉ_dẫn hay định_hướng làm việc_gì theo kiểu ra mệnh_lệnh ; cầm hoặc nắm lấy một_cách bất_ngờ ; đưa hay bắt đinh_vít vào dưới bề_mặt , như vào trong một lỗ đã khoan sẵn ; thực_hiện cử_động nắm lấy hoặc chộp lấy bằng tay ; bắt ai làm_gì ; đẩy đi , đẩy tới hoặc ép bằng lực ; tóm được cổ hay cổ áo ; bắt được bằng cách săn_bắn hay đánh bẫy ; nắm quyền_sở_hữu tạm_thời vì lí_do an_ninh hay pháp_luật
cự_tuyệt	từ_chối thừa_nhận hay công_nhận ; hành_động khiếm_nhã có chủ_ý ( thường để biểu_hiện sự tức_giận hay không đồng_ý ) ; được đặc_trưng hoặc thể_hiện sự phủ_định hay từ_chối ; không có tính_chất tích_cực ; phản_đối bỏ_phiếu ; từ_chối việc tán_thành ; cự_tuyệt sự đồng_ý ; kháng_cự theo miễn_dịch khi đưa mô hoặc bộ_phận lạ nào_đó vào trong ; không làm việc_gì được ai đó đề_nghị , như trong lời cầu_xin hay lời yêu_cầu ; kiên_quyết không nhận quyền_sở_hữu cái gì ; thể_hiện sự không nhiệt_tình , chưa sẵn_sàng làm cái gì ; từ_chối thẳng_thừng và ngay_lập_tức ; không cho ai gia_nhập vào hoặc không thừa_nhận tư_cách hội_viên của ai đó
bãi_bỏ	từ_chối thừa_nhận hay công_nhận ; từ_bỏ không theo_đuổi một cái gì mặc_dù có_thể và được yêu_cầu thực_hiện điều đó ; tuyên_bố không có hiệu_lực hoặc làm cho mất giá_trị ; làm cho không có hiệu_quả ; đặt dấu_chấm hết ; hành_động hủy_bỏ ; hủy_bỏ chính_thức hay hợp_pháp ; chính_thức bãi_bỏ ; hành_động bỏ đi một sự sắp_xếp nào_đó ; bỏ đi ; không công_bố hoặc thừa_nhận công_khai ; không được công_nhận hoặc thừa_nhận ; không được công_nhận ; tuyên_bố không có hiệu_lực
thi_đấu	thiết_lập sự đối_lập hoặc sự cạnh_tranh nhau ; tranh tài với một đối_thủ trong một môn thể_thao , trò_chơi hoặc trận đấu
phá_vây	hoạt_động quân_sự giúp quân_bị bao_vây xông ra khỏi vị_trí của mình
hiện_trạng	tình_trạng hiện_nay ; trạng_thái thực tồn_tại một_cách khách_quan
tình_cảnh	trạng_thái hoặc vị_trí mà bạn thấy mình ; tình_trạng tài_chính của một người ( tốt hay xấu ) ; trạng_thái tại một thời_điểm cụ_thể ; tình_trạng chung của sự_vật ; sự kết_hợp của hoàn_cảnh tại một thời_điểm nhất_định ; sự khó_khăn phức_tạp , nguy_kịch hay bất_thường
vượt_tuyến	[]
dứt_điểm	nỗ_lực ghi_điểm trong trận đấu
cá_hồng	cá châu Úc được dùng làm thực_phẩm , có mình hồng đốm xanh
cá_chai	[]
bằng	trên một mặt_phẳng ngang hoàn_toàn ; tương_ứng về kích_thước , mức_độ hoặc phạm_vi ; có bề_mặt mà không có độ dốc , độ nghiêng , trong đó không có phần cao hơn hoặc thấp hơn ; tài_liệu chứng_nhận việc hoàn_thành một khóa học ; có cùng số_lượng , phẩm_chất , hoặc có số_đo giống một cái khác ; giấy chứng_nhận năng_lực mà trường cao_đẳng hay trường đại_học trao để chứng_nhận rằng người nhận đã hoàn_tất khóa học ; cộng lên đến ; đồng_nhất hay tương_đương với cái gì đó ; được coi là bằng nhau về phẩm_chất hoặc khả_năng ; phẳng theo chiều ngang
văn_bằng	tài_liệu chứng_nhận việc hoàn_thành một khóa học
tĩnh_dưỡng	không chuyển_động ; ở trạng_thái nghỉ_ngơi
lộn_xộn	trong một khối lẫn_lộn ; không gọn_gàng và ngăn_nắp ; tất_cả được trộn lẫn hoặc được hoà_trộn cùng nhau ; không được sắp_xếp theo thứ_tự ; nổi_bật bởi sự cẩu_thả nghiêm_trọng ; bẩn_thỉu và mất trật_tự ; hành_động tạo ra sự liên_kết không có trật_tự giữa các yếu_tố với những đặc_tính bị mất đi và những nét khác_biệt bị pha_trộn ; hoàn_toàn không theo thứ_tự và không đều , rối_rắm ; có sự sắp_xếp không theo trật_tự ; mang đến sự lộn_xộn cho ; thiếu ngăn_nắp hoặc trật_tự ; thiếu kỉ_luật hoặc sự kiểm_soát ; thiếu trật_tự hay thiếu sự sắp_xếp có phương_pháp ; gồm sự sắp_xếp ngẫu_nhiên của các loại khác_nhau ; thiếu cấu_trúc rõ_ràng và tính tổ_chức
bạc_đãi	đối_xử tàn_tệ , trái với đạo_lí ; đối_đãi thô_bạo ; gây ra đau_khổ ; đối_xử tàn_nhẫn hoặc vô_nhân_đạo ; đối_xử tàn_nhẫn ; đối_xử không tốt ; đối_xử một_cách tồi_tệ
trọng_đãi	[]
phân_li	( thuộc về từ ) đề_cập đơn_lẻ và không ngoại_lệ cho các thành_viên của nhóm
đoàn_tụ	làm cho hoặc trở_thành một đơn_vị duy_nhất
nhốt	sự hạn_chế tự_do của một người bằng cách giam lại ; tước đi sự tự_do ; lấy đi sự tự_do ; giữ ở trong chuồng , cũi , hay nơi được chắn kín , không cho tự_do đi_lại , hoạt_động ; cho vào trong , hay giữ ở trong một chuồng ; đưa vào trong cũi ; tình_trạng bị giam_giữ về thể_chất ; đặt vào một nơi mà thứ gì đó không_thể bị lấy đi hay một người nào_đó không_thể thoát ra ; giữ trong một hàng_rào vây quanh hoặc bất_cứ phạm_vi hay giới_hạn nào ; giữ trong một cái chuồng ; giữ khoảng_cách với thế_giới bên ngoài hoặc tự giam mình như ở trong tu_viện ; cho vào trong một cái chuồng
thả	ban tự_do cho ; làm cho bay hoặc lơ_lửng ; bất_ngờ buông ra ; cho lên không_trung hoặc làm cho lơ_lửng ; hành_động thả vật gì hoặc ai đó ; đặt xuống_nước ; thả ra ; như do ai đó nắm chặt ; cho xuống sông ; ban tự_do cho ; giải_thoát khỏi sự giam_cầm ; thả cho trôi ; thả cái gì xuống với một âm_thanh rơi tõm ; trả tự_do khỏi sự chiếm_hữu nô_lệ hoặc tình_trạng nô_lệ ; để cho ăn_ở đồng_ruộng , đồng_cỏ hay bãi cỏ ; thả xuống_nước tạo thành âm_thanh
nội_tiết	thuộc hoặc thuộc về tuyến_nội_tiết hoặc chất tiết của chúng
huyệt	[]
phụ_bản	[]
truyện_tranh	[]
phong_thư	vật chứa mỏng thường để đựng thư ; thông_điệp viết được gửi đến một người hay một tổ_chức
địa_chỉ	địa_điểm được viết lên những bức thư hay những bưu_kiện mà sẽ được đưa đến địa_điểm đó ; ( tin_học ) vị_trí chính_xác trong hệ máy_tính được định_danh bởi một tên , một con_số , hoặc một nhãn mã ; những thông_tin cụ_thể về chỗ ở , nơi làm_việc của một người , một cơ_quan , v . v .
thời_bình	khoảng thời_gian không có chiến_tranh
thời_chiến	gợi nhớ đến chiến_tranh hay cuộc_sống thời_chiến ; quãng thời_gian xảy_ra xung_đột vũ_trang
áo_quan	[]
quan_tài	cái mà trong đó chứa xác_chết được chôn_cất hay hoả_táng
trẩy_hội	[]
ví	xem hay coi là tương_đương , bằng nhau hay giống nhau ; túi nhỏ dùng để đựng tiền ; đồ_dùng cỡ nhỏ bỏ_túi hoặc cầm tay , dùng để đựng giấy_tờ và tiền_mặt ; vật chứa dùng để đựng tiền và đồ_dùng cá_nhân hoặc phụ_kiện nhỏ ( đặc_biệt là của phụ_nữ )
nhức_nhối	là nguồn_gốc của nỗi đau ; bị phồng to lên do viêm và rất đau ; vô_cùng đau_khổ ; làm thấy oán_giận hay giận_dữ ; có tính_chất gây ra sự đau_đớn hay bất_hạnh
nhấp_nhỏm	[]
cũ_kỹ	[]
mới_mẻ	khác so với ( những ) cái trước đó ; gốc và thuộc một loại chưa thấy trước đó ; mới hoàn_toàn hay nghuyên bản ; ( thuộc một chu_trình ) bắt_đầu hay xảy_ra lại ; thuộc hay tạo ra thứ gì đó mới_mẻ và khác_thường ; hay cái gì đó được tạo ra hay nghĩ ra đầu_tiên
nhạo	đối_xử hay nói_năng với sự coi_thường
hạ_bút	[]
sân_vận_động	cấu_trúc lớn dành cho các môn thể_thao ngoài_trời hoặc các hoạt_động giải_trí ; mảnh đất được chuẩn_bị cho một trận đấu
khán_đài	khu_vực của rạp_hát hay khán_phòng nơi khán_giả ngồi ; chỗ ngồi theo tầng thường làm từ gỗ , nơi mọi người có_thể ngồi xem sự_kiện
chủ_nghĩa_hình_thức	sự tuân_thủ sâu_sát những hình_thức đã được định ra hay hình_thức bên ngoài ; học_thuyết cho rằng cấu_trúc hình_thức hơn là nội_dung , cái nên được trưng ra
truyện_tranh	[]
được	không thuộc đối_tượng bị đánh_bại ; trải qua ( những trạng_thái , những trải_nghiệm tinh_thần hoặc thể_chất ) ; đáp lại đúng theo như đòi_hỏi , yêu_cầu của một cái gì đó ; được thoả_mãn yêu_cầu hoặc trong điều_kiện thoả_đáng ; đạt được một chữ_số hay chữ_cái nào có_thể quy ra điểm hay thành_tích ; thành_công trong việc đạt được_cái gì
mất	không tạo ra tiền trong kinh_doanh ; bị thua_lỗ hoặc không tạo ra lợi_nhuận ; mất ( cái gì đó ) hoặc mất quyền đối_với ( cái gì đó ) vì một lỗi , sai_phạm hay tội ; đòi_hỏi ( thời_gian hoặc không_gian ) ; không giữ hoặc duy_trì được ; ngừng có cái gì đó theo nghĩa vật_chất hoặc trừu_tượng ; phải chịu_đựng hay phải đối_mặt với nỗi đau của cái chết ; chịu_đựng sự mất_mát của một người do cái chết hoặc sự chia_lìa ; mất khỏi cuộc_sống vật_chất , mất tất_cả các thuộc_tính và chức_năng cơ_thể cần_thiết để duy_trì sự sống ; mất khỏi tầm kiểm_soát ; mất dấu ; sử_dụng hết ; không có hoặc không còn cái gì nữa ; chấm_dứt tồn_tại ; mất đi hoặc đến hồi kết_thúc ; trở_nên vô_hình hoặc không thấy rõ
hiểu	hiểu được một ngôn_ngữ ; thấy và hiểu , có mắt nhìn tốt ; hiểu một thứ gì đó được viết hay in ra ; trở_nên có ý_thức ; hiểu ra ; hiểu ; lĩnh_hội về mặt trí_tuệ ( một ý_tưởng hay tình_huống ) ; hiểu , thường sau một_chút khó_khăn ban_đầu ; tin rằng như_vậy ; giải_thích điều gì đó theo một_cách nhất_định ; truyền_đạt một ý_nghĩa hay ấn_tượng đặc_biệt ; hiểu ; giải_thích ý_nghĩa của cây_cọ , lá chè , ruột , bầu_trời và cả hành_vi con_người ; hiểu được ý_nghĩa của điều gì đó ; nắm được ý_nghĩa , nội_dung vấn_đề được nói tới ; hiểu rõ ; hiểu , biết hay nhận_thức một thực_tế hoặc một phần thông_tin đặc_biệt ; sở_hữu kiến_thức hay thông_tin
tiên_lượng	nhận thấy nhờ trực_giác hoặc qua khả_năng cảm_nhận không_thể giải_thích ; đoán trước tình_hình , sự_việc có_thể xảy_ra ; dự_đoán về diễn_biến của một căn_bệnh
quét_dọn	quét_dọn những đồ rác_thải , vật phế_thải ; làm sạch bằng cách quét_dọn ; loại_bỏ những chất bẩn để làm sạch
loại_bỏ	bị bãi_bỏ hay bị loại_bỏ ; không được cân_nhắc hoặc bị loại khỏi cuộc_thi ; từ_chối thừa_nhận hay công_nhận ; giữ không cho cái gì diễn ra hoặc phát_sinh ; làm cho không_thể xảy_ra ; ngừng xem_xét ; đặt ra ngoài sự xem_xét của toà_án ; huỷ , bỏ , hoặc đảo_ngược một hành_động hay tác_dụng của nó ; vứt bỏ hay loại_bỏ ; yêu_cầu phải ra ngoài ; lấy đi hoặc loại_bỏ ; loại_bỏ ; kết_thúc hoặc dập bỏ một_cách mạnh_mẽ ; di_chuyển ra khỏi trung_tâm hoạt_động hay sự chú_ý ; đặt vào một địa_vị xã_hội thấp hơn ; làm mất đi ; cắt đứt mọi quan_hệ , thường với một_cách không lịch_sự hoặc vô_trách_nhiệm ; xoá thông_tin được ghi lại dưới dạng số_hoá hoặc từ_tính ; bỏ đi cái gì được coi là vô_dụng hay không mong_muốn ; loại_bỏ ( các tài_liệu ) vì vô hiệu_lực ; loại_bỏ ; loại_bỏ ; phẫu_thuật loại_bỏ ( một bộ_phận ) ; bỏ đi ; loại_bỏ ( cầu_thủ đập bóng ) , ( dùng cho cầu_thủ ném bóng ) ; loại_bỏ cái gì đó cụ_thể bằng cách nâng , đẩy hoặc lấy đi , hoặc loại_bỏ cái gì đó trừu_tượng ; loại_bỏ hoặc làm cho không_thể trông thấy ; hành_động loại_bỏ ; kháng_cự theo miễn_dịch khi đưa mô hoặc bộ_phận lạ nào_đó vào trong ; loại_bỏ những thành_phần không mong_muốn ; đuổi ra khỏi một tổ_chức hay một nhóm ; cho ra hoặc đuổi ra khỏi một nơi ; vứt bỏ cái gì đó trừu_tượng ; tuyên_bố không đạt đủ tiêu_chuẩn ; loại_bỏ ( một người có_thể trở_thành mối đe_doạ ) bằng cách sát_hại ; loại_bỏ ; làm mà không nắm giữ hoặc không tuân_thủ
bay_hơi	toả ra hơi_nước ; tăng lên thành dạng hơi ; làm cho dễ bay_hơi ; khiến cho bốc_hơi
bay	di_chuyển bằng đường_không ; toả ra hơi_nước ; đi qua ( một vùng_đất hoặc biển ) bằng máy_bay ; dùng tay , chân và các thiết_bị chuyên_dụng điều_khiển máy_bay ; tăng lên thành dạng hơi ; lơ_lửng trong không_khí , dường_như bất_chấp trọng_lực ; công_cụ cầm tay nhỏ có lưỡi kim_loại dẹt , dùng để xúc , trải rộng vữa hoặc các vật_liệu tương_tự ; bị cuốn đi hoặc dẫn đi theo luồng không_khí ; cuộn lên dưới dạng một đám mây ; bị phân_tán hay lan ra ; toả ra ( khí hoặc mùi ) ; di_chuyển qua các tầng không_khí , ở trên không ; đi bằng máy_bay
dễ_dàng	yêu_cầu hoặc đòi_hỏi không cần nỗ_lực ; đạt được với ít nỗ_lực hoặc hy_sinh ; thường đạt được một_cách bất_hợp_pháp ; đạt được nhờ rất ít công_sức hay nỗ_lực ; thiếu chiều sâu ; không gặp khó_khăn ; đòi_hỏi ít nỗ_lực ; không nặng_nề hay đòi_hỏi ; tạo ra hoặc thực_hiện dễ_dàng và không khó_khăn ; trơn_tru và không bị ép_buộc hay cố_gắng trong chuyển_động ; không khắt_khe ; làm cho dễ_dàng hơn
khó_khăn	không may hay khó để chống_đỡ ; khó để xử_lí hoặc phá hỏng ; nhân_tố gây rắc_rối cho việc đạt kết_quả tích_cực hay có xu_hướng gây ra kết_quả tiêu_cực ; đặc_trưng bởi hoặc nhìn thấy rõ sự nghèo_đói ; đầy khó_khăn hay thách_thức ; cố_gắng không dễ_dàng ; vấn_đề không dễ để giải_quyết , đòi_hỏi nhiều suy_nghĩ và nỗ_lực vất_vả ; có biểu_hiện nỗi đau_buồn , sự đau_khổ , nguy_hiểm hoặc tình_cảnh khó_khăn , thiếu_thốn
gạ	tiếp_cận với ý_đồ quan_hệ tình_dục ; chủ_động dành sự chú_ý đến ai , thường về mặt tình_dục , nhưng không được người kia mong_đợi ; xúi_giục làm_tình ; chủ_động dành sự chú_ý và lời_lẽ để tán_tỉnh ai , thuyết_phục họ nghe theo lời mình , thường để đạt được mục_đích tình_dục và không được người kia mong_đợi từ trước ; hành_vi bông_đùa , sử_dụng lời_lẽ gợi_tình với mục_đích kích_thích hứng_thú tình_dục
gạ_gẫm	tiếp_cận với ý_đồ quan_hệ tình_dục ; bị quyến_rũ hoặc xúi_bẩy khỏi trách_nhiệm , kỉ_luật hay quy_tắc đạo_đức ; chủ_động dành sự chú_ý đến ai , thường về mặt tình_dục , nhưng không được người kia mong_đợi ; đề_nghị quan_hệ ( tình_dục ) ; quấy_rầy hoặc hành_hung về mặt tình_dục ; có những hành_vi không đứng_đắn ; xúi_giục làm_tình ; chủ_động dành sự chú_ý và lời_lẽ để tán_tỉnh ai , thuyết_phục họ nghe theo lời mình , thường để đạt được mục_đích tình_dục và không được người kia mong_đợi từ trước ; hành_vi bông_đùa , sử_dụng lời_lẽ gợi_tình với mục_đích kích_thích hứng_thú tình_dục
vắng_tanh	[]
lịch_bịch	[]
nhậm_chức	hành_động đạt tới hoặc nhận được chỗ ở văn_phòng , quyền_lợi hoặc vị_trí mới ( đặc_biệt là ngôi vua ) ; đảm_đương một chức_vụ , nhiệm_vụ , hay danh_hiệu ; chính_thức nhận chức_vụ ; gánh_vác trách_nhiệm hay chức_vụ
nhiệm_chức	hành_động đạt tới hoặc nhận được chỗ ở văn_phòng , quyền_lợi hoặc vị_trí mới ( đặc_biệt là ngôi vua ) ; đảm_đương một chức_vụ , nhiệm_vụ , hay danh_hiệu
hồ_sơ	tập_hợp các hồ_sơ liên_quan ( bằng văn_bản hoặc điện_tử ) được lưu_trữ cùng nhau ; tài_liệu có_thể được dùng làm bằng_chứng hợp_pháp cho một giao_dịch ; phân_tích ( thường dưới dạng đồ_hoạ ) biểu_diễn các đặc_điểm của cái gì đó ; bất_kì thứ gì ( như tài_liệu , đĩa ghi_âm , hoặc tranh_ảnh ) cung_cấp bằng_chứng vĩnh_viễn hoặc thông_tin về những sự_kiện trong quá_khứ
bằng_cớ	cái thực_tế dùng để chứng_minh giúp thiết_lập chân_lí về một điều gì đó ; cơ_sở cho niềm_tin hay sự không tin ; tri_thức mà trên đó niềm_tin được xây_dựng ; ( luật_pháp ) vật được tạo ra để bác_bỏ sự_thật đang được điều_tra làm rõ tại tòa_án ; dấu_hiệu cho thấy điều gì đó là hiển_nhiên ; thông_điệp phi ngôn_ngữ
hổ_thẹn	cảm_thấy xấu_hổ , tội_lỗi , bối_rối hoặc ăn_năn ; sợ_hãi đến khúm_núm ; gây ra hành_vi phạm_tội về sự nhạy_cảm về đạo_đức và gây tổn_hại đến danh_tiếng ; buộc phải trải qua một cảm_giác xấu_hổ ; trạng_thái xấu_hổ hay hổ_thẹn
bắt_buộc	bị giới_hạn vào một điều_kiện sống nhất_định ; đòi_hỏi hoặc yêu_cầu ; bắt phải làm dưới sức_ép hay ép_buộc về mặt tinh_thần , thể_chất hay đạo_đức ; sự ràng_buộc về mặt đạo_đức và pháp_luật ; bắt phải hay ép_buộc vào một tình_trạng hoặc hành_động cụ_thể ; buộc phải cư_xử theo một_cách nhất_định ; sử_dụng lực để làm cho thứ gì xảy_ra ; thứ cần có hoặc thiết_yếu ; thúc_đẩy hoặc bắt_buộc ( một người ) phải hành_động ; ép_buộc hoặc thúc_đẩy ; chỉ_dẫn hay dùng bằng quyền_lực ra_lệnh ; bắt ai làm_gì ; bị ràng_buộc bởi một giao_ước ; khiến bị mắc nợ
dấu_hiệu	đặc_điểm mà được coi là dấu_hiệu của vị_thế , địa_vị ( quyền_lực hay chất_lượng hay cấp_bậc nhất_định ) ; điều gì đó kích_thích hành_động ; sự chỉ báo có_thể nhận_biết cái gì đó không xuất_hiện ngay_lập_tức ; hành_động hay cử_chỉ không lời mà biểu_hiện nội_dung ; đặc_điểm hay thuộc_tính để phân_biệt ; kí_hiệu để phân_biệt ; đơn_vị ngôn_ngữ cơ_bản liên_kết cái biểu_hiện nghĩa tới nghĩa được biểu_hiện ; cái dự_báo trước về sự_vật , hiện_tượng gì hay cách tiếp_cận cái gì hoặc ai đó ; dấu_hiệu ám rằng chỉ cái gì đó đã tồn_tại , đã xảy_ra
đặc_trưng	có tính_chất riêng_biệt và tiêu_biểu , làm cho phân_biệt được với những sự_vật khác ; về đặc_tính giúp phân_biệt hay xác_định riêng_biệt thứ gì đó ; thuộc_tính hay khía_cạnh nổi_trội của một cái gì đó ; cái khiến một thứ là nó và khiến nó khác những thứ khác ; sự riêng_biệt và tiêu_biểu trong tính_cách cá_nhân ; được áp_dụng riêng cho phạm_trù , điều_kiện hay khu_vực nhất_định ; yếu_tố quan_trọng nhất ; phù_hợp với một loại_hình ; thể_hiện đặc_tính hay phẩm_chất đặc_trưng để nhận_dạng một nhóm , loại hay mục ; thể_hiện đặc_trưng lãnh_thổ ; bảo_vệ lãnh_thổ chống lại kẻ xâm_nhập
người_dân	thành_viên bản_địa hoặc nhập_tịch của một quốc_gia hay một tổ_chức chính_trị ; người_dân bình_thường nói_chung ; nhóm người nói_chung ( đàn_ông , phụ_nữ hay trẻ_em ) ; số_lượng lớn các công_dân của một bang hay một nước ; người sống trong một vùng lãnh_thổ hay quốc_gia
tộc_người	[]
bè_cánh	phe tìm_kiếm quyền_lực bằng âm_mưu ; phe_nhóm bất_đồng ; sự chia một nhóm thành nhiều phe đối_lập
vây_cánh	người mà chấp_nhận sự lãnh_đạo của người khác
bật_lửa	[]
giảm_xóc	bộ_phận của xe_máy có tác_dụng làm giảm bớt xóc
sinh_vật_cảnh	[]
không_trung	bầu khí_quyển ngay trên trái_đất ; vùng không_gian từ mặt_đất trở_lên
chần_chờ	đắm_chìm trong suy_tư , sự cân_nhắc , hoặc cuộc tranh_luận ; hành_động do_dự , cho thấy sự không nhất_quán ; dời đi một_cách chậm_chạp và lưỡng_lự ; tạm ngừng hoặc ngập_ngừng khi_không chắc_chắn hoặc miễn_cưỡng ; lập_lờ nước_đôi , không rõ_ràng ; được đặc_trưng bởi thiếu sự quyết_đoán và sự vững_chắc ; thiếu tính quyết_đoán ; không_thể hành_động hoặc quyết_định một_cách nhanh_chóng hoặc vững_chắc ; đặc_trưng bởi sự không quyết_đoán ; lung_lay trong ý_kiến hoặc quan_điểm ; không được xác_định rõ_ràng
dứt_khoát	được xác_định một_cách rõ_ràng hoặc sắc_bén trong tâm_trí ; đặc_trưng bởi sự nhanh_chóng và chắc_chắn ; không cho_phép sự mâu_thuẫn hoặc từ_chối ; đặc_trưng nhờ sự quyết_định và tính chắc_chắn ; không có hạn_chế hay ngoại_lệ ; chính_xác và rõ_ràng hoặc dễ_dàng quan_sát được ; không để lại hàm_ý ; chấm_dứt tất_cả các tranh_cãi hoặc hành_động ; không_thể lầm ; được xác_định hoặc hình_thành rõ_ràng
tư_thế	cách đi_đứng , ăn_mặc , nói_năng , v . v . của một người , phù_hợp với cương_vị của người đó ; cử_động của tay hay thân mình để nhấn_mạnh hoặc giúp thể_hiện suy_nghĩ , cảm_xúc ; tư_thế được được diễn trong sân_khấu kịch ; tư_thế đứng ; thế bay của máy_bay hoặc tàu_vũ_trụ tương_ứng với một hệ quy chiếu ; đặc_điểm về dáng_điệu của người ; sự sắp_xếp của phần tân và các chi
phong_thái	[]
máy_vi_tính	máy để thực_hiện tính_toán tự_động
phím	kí_hiệu thể_hiện độ cao_thấp và khoảng thời_gian của một giai_điệu ; dụng_cụ bao_gồm các phím trên đàn pi - a-nô , đàn óc - gan , máy đánh chữ , máy xếp chữ hoặc tương_tự ; miếng nhỏ bằng gỗ , nhựa hay kim_loại chắn dây trên một_số loại đàn dây ( violon hoặc celo hoặc ghita ) để định cung trên cần đàn
sụp_đổ	mất kiểm_soát cảm_xúc ở ai đó ; mất địa_vị hoặc quyền_lực ; đổ xuống , như_thể đang sập ; chịu sự sụp_đổ , bị lật_đổ hoặc thất_bại bất_ngờ ; sụp_đổ , có_thể được hiểu theo cả nghĩa_đen và nghĩa_bóng
kìm_nén	cố_gắng giữ bản_thân , không để biểu_hiện ra trong lúc hành_động ; giữ để khỏi toả ra hoặc thoát ra ; giữ để khỏi toả ra hoặc thoát ra ; kìm_nén lại vì ý_thức ; kháng_cự lại việc_làm điều gì đó ; làm giảm cường_độ ; làm dịu đi ; giữ trong giới_hạn ; giữ trong giới_hạn và kiểm_soát ; giữ tâm_thức ở chừng_mực nhất_định không cho tự_do hoạt_động ; cản_trở hay làm chậm lại hành_động hay ảnh_hưởng của ; giảm tần_suất hay mức_độ nghiêm_trọng hoặc dừng hẳn lại ; bị hạn_chế , quản_lí hoặc giữ trong giới_hạn nhất_định ; khắc_phục hay làm giảm bớt ; giữ lại một suy_nghĩ hoặc một cảm_giác về ai hay cái gì ; kiềm_chế làm việc_gì ; giữ trong tầm kiểm_soát
mắc_kẹt	tắc lại và không nhúc_nhích ; bị mắc hoặc bị giữ cố_định ; giữ hoặc bắt như bằng một cái bẫy ; không có khả_năng di_chuyển xa hơn_nữa
cầm_giữ	cầm hoặc giữ bằng tay hoặc cầm chặt
hình_hoạ	[]
khí_quyển	khối khí bao quanh Trái_Đất ; vỏ bọc khí chung quang bất_kì thiên_thể nào
thuộc_địa	một thuộc_địa mới được thành_lập ( đặc_biệt là ở các thuộc_địa của Bắc_Mĩ ) ; khu_vực địa_lí do một nước ở xa kiểm_soát về mặt chính_trị
kiều_dân	người_dân của nước này cư_trú ở một nước khác
nhà_hát	toà nhà nơi các buổi biểu_diễn văn_nghệ hoặc các chương_trình chiếu_phim ảnh được trình_chiếu ; nhà lớn chuyên_dùng làm nơi trình_diễn các tiết_mục nghệ_thuật sân_khấu cho công_chúng xem
sân_khấu	bục lớn trên đó mọi người có_thể đứng và khán_giả có_thể trông thấy họ ; vật_mang tính biểu_trưng gồm phông_nền và các đồ_dùng biểu_diễn khác dùng để nổi_bật đặc_điểm của nơi diễn ra vở kịch
thìa	lượng nằm trong thìa ; đồ trong bộ_đồ dao dĩa thìa với đáy nông hình bát và có tay_cầm ; được dùng để khuấy hoặc múc thức_ăn
muỗng	vật_dụng hình thìa có cái cán dài ; dùng để chuyển chất_lỏng từ vật chứa này này sang vật khác
tỏ	[]
biểu_lộ	là một dấu_hiệu hay tín_hiệu ; xuất_hiện trên mặt của một người ; đưa ra một thông_báo nhằm loan tin cho mọi người biết_điều gì ; làm cho nhìn thấy được ; tỏ ra những thuộc_tính , đặc_tính , hiểu_biết , hay kĩ_năng ; cho thấy sự có_mặt của nó hoặc làm cho xuất_hiện ; lời_nói , dáng_điệu gợi_ý , để người khác tự suy_nghĩ , tự hiểu như một khả_năng ; cho_biết ý_nghĩ bằng lời_nói hoặc bằng tín_hiệu ; hành_động thể_hiện của vật trưng_bày ; hoạt_động như một phương_tiện truyền_dẫn thứ gì đó
chiến_tranh	tiến_hành xung_đột vũ_trang chống lại kẻ_thù ; gợi nhớ đến chiến_tranh hay cuộc_sống thời_chiến ; hành_động đấu_tranh giữa các bên tham_chiến
trận_chiến	cuộc_thi hoặc cuộc_chiến ( nhất_là giữa các võ_sĩ hay đô_vật ) ; đụng_độ căng_thẳng giữa các phe đối_đầu trong một cuộc chiến_tranh
cộc	chỉ quần_áo phụ_nữ ; rất ngắn , có gấu phía trên đầu_gối ; ( cảm_nhận không_gian cơ_bản ) có độ dài nhỏ hay không đủ dài
va	bang thuộc miền đông nước Mĩ ; một trong 13 thuộc_địa sơ_khai ; một trong những bang thuộc Liên_minh miền Nam_Hoa_Kì trong cuộc nội_chiến Mĩ
tính_sổ	[]
giám_đốc_thẩm	[]
hơn	tự mình phân_biệt ; ( so_sánh hơn của much , dùng với danh_từ không đếm được ) lượng từ chỉ trạng_thái lớn hơn về mặt kích_cỡ , phạm_vi hoặc mức_độ ; có vị_trí hàng_đầu hoặc điểm_số cao hơn trong một cuộc_thi ; lớn hơn về số_lượng ; trội hơn đối_tượng khác ( trong cùng cấp , cùng bộ hay cùng loại ) về độ xuất_sắc , chất_lượng , tính thích_hợp , sự mong_muốn hay khéo_léo hơn người khác ; hơn đối_tượng khác ( trong cùng cấp , cùng bộ hay cùng loại ) về độ xuất_sắc , chất_lượng , tính thích_hợp , sự mong_muốn hay sự khéo_léo hơn người khác ; tốt hơn
thua	mất quyền_lực ; đặc_biệt là không thành_công trong bầu_cử hay thi_đấu ; ( so_sánh hơn của few dùng với danh_từ đếm ) lượng từ chỉ trạng_thái số gì đó nhỏ hơn ; bị đối_phương giành phần hơn , phần thắng ; không chiến_thắng trong cuộc tranh_đấu hay cuộc đọ sức giữa các bên ; không được gì hoặc không thắng ai đó ; chịu để cho đối_phương giành phần hơn , phần thắng trong cuộc tranh_chấp hoặc đọ sức giữa hai bên
cựu_binh	người mà đã từng phục_vụ trong quân_ngũ
tân_binh	người lính mới nhập_ngũ ; thành_viên hay người trợ_tá mới trong lực_lượng_vũ_trang
tính_sổ	[]
nuôi_dưỡng	cung_cấp các chất dinh_dưỡng ; thúc_đẩy sự phát_triển ; giúp phát_triển , giúp lớn lên ; duy_trì ( một thuyết , một suy_nghĩ hay một tình_cảm ) ; nuôi và chăm_sóc từ khi còn ẵm_ngửa ; nuôi_dưỡng ; giữ lại một suy_nghĩ hoặc một cảm_giác về ai hay cái gì ; ( sinh_lí_học ) quá_trình hữu_cơ nuôi_dưỡng hay được nuôi_dưỡng ; quá_trình giúp sinh_vật tiêu_hoá thức_ăn và sử_dụng nó để tăng_trưởng và duy_trì ; cung_cấp dinh_dưỡng ; phục_vụ như một y_tá ; chăm_sóc người bị bệnh hay những người tàn_tật
ngữ_cảnh	diễn ngôn xung_quanh đơn_vị ngôn_ngữ và giúp xác_định việc giải_thích
văn_cảnh	diễn ngôn xung_quanh đơn_vị ngôn_ngữ và giúp xác_định việc giải_thích
hâm_nóng	chạy cho_đến khi nhiệt_độ hoạt_động bình_thường được đạt tới ; làm nóng hoặc làm nóng hơn
cải_biến	thay_đổi hoặc sửa_đổi về hình_dáng , diện_mạo hoặc bản_chất ; tạo nên sự thay_đổi , biến_đổi hay khác_biệt ; dẫn_dắt hay bắt_buộc từ_bỏ một hành_động sai hay hướng đi xấu trong cuộc_sống , kiểm_điểm và sửa_đổi theo một hướng đi đúng
bón	cung_cấp phân_bón hoặc thêm dưỡng_chất cho ; biến từ thể lỏng sang trạng_thái đặc hoặc rắn
tẩm	làm cho chất bột hay chất đường dính lên bề_mặt thức_ăn ; tạo một lớp lên bề_mặt cái gì đó ; rưới lên , phủ lên trước khi nấu_ăn ; hành_động thấm_đẫm hoàn_toàn bằng một chất_lỏng
thảm	vật_thể tự_nhiên trông giống hay có chức_năng giống một chiếc thảm ; tấm lót phẳng và dày được sử_dụng để bao_phủ nền nhà ; vật phủ sàn gồm tấm vải dày , nặng ( thường có_mặt mịn hoặc tuyết ; tỏ ra buồn_bã thường bởi điều gì đó đã qua ; quá buồn_rầu ; vật để che_phủ sàn nhà
thê_thảm	[]
lắp_đặt	lắp_đặt để sử_dụng
nhồi_nhét	lấp đầy quá mức đến_nỗi chức_năng bị suy_giảm ; lấp đầy lỗ trống ; đặt một thứ vào nơi mà không_gian đã đầy ; cung_cấp thứ gì đó cần_thiết ( cho một thiết_bị ) ; nén lại thành một nùi ; nhét người vào cho_đến lúc chật
tạo_hoá	[]
tạo_vật	[]
hen	chứng rối_loạn hô_hấp với đặc_điểm thở khò_khè ; thường có nguồn_gốc do dị_ứng
cúm	tình_trạng bị nhiễm virus ở mức_độ nhẹ liên_quan đến mũi và đường hô_hấp ( nhưng không liên_quan đến phổi ) ; bệnh do virus có tính lây_nhiễm cao gây sốt nghiêm_trọng
mệt_mỏi	cảm_giác không thoải_mái , vì cơ_thể hoặc tinh_thần phải chịu_đựng một điều gì đó không hay , không hợp , không thích ; thiếu niềm say_mê hay hoạt_bát ; kiệt_sức về thể_chất và tinh_thần ; cảm_thấy khó_chịu hoặc đau về mặt thể_chất ; bị ảnh_hưởng sâu_sắc bởi một cảm_giác mạnh ; ở vào tình_trạng phải bỏ ra nhiều sức_lực hay tâm_trí vào một việc_gì gian_khổ hoặc khó_chịu ; suy_giảm sức_mạnh hay năng_lượng ; thiếu sức_mạnh hay sinh_lực ; cảm_thấy không khoẻ hoặc không thoải_mái
mỏi_mệt	[]
tắc_nghẽn	sự dồn tích gây ra do tắc hay nghẽn
thông_suốt	[]
trọng	[]
coi_trọng	nhấn_mạnh , lựa_chọn ra vì quan_trọng và cần_thiết phải có ; coi_trọng , đánh_giá cao
đẽo	cắt những mẩu nhỏ hay gọt cạo từ ; cắt bớt phần thô ( gỗ ) để đạt chuẩn về độ rộng và độ dày ; làm đứt bằng một cái rìu ; tạo_hình bằng rìu ; tạo ra một cái gì đó , thường để thực_hiện một chức_năng nhất_định ; tạo ra một cái gì đó , thường để thực_hiện một chức_năng nhất_định ; tạo_hình , hoặc cắt bằng cách làm đứt rời khỏi bề_mặt từng mảnh của một khối ; cắt bỏ các cạnh khỏi và cắt xuống đến cỡ mong_muốn
bắt	cầu_thủ có nhiệm_vụ bắt bóng ; bắt hoặc khiến ai đó hoặc cái gì đó phải hành_xử theo một_cách nào_đó ; làm cho phải tham_gia hay không tham_gia vào một hành_động hoặc phải rơi vào hay phải ra khỏi một một trạng_thái , theo cả nghĩa_đen hoặc nghĩa_bóng ; nắm lấy một_cách vội_vàng hay háo_hức ; di_chuyển bằng một phương_tiện giao_thông , hoặc theo một tuyến đường nhất_định ; kèm cầu_thủ chạy về gôn để loại cầu_thủ đó ; bắt phải làm dưới sức_ép hay ép_buộc về mặt tinh_thần , thể_chất hay đạo_đức ; dùng vũ_lực nhằm bắt_giữ ; tác_động , thậm_chí ép_buộc khiến người nào làm việc_gì ; làm một_cách mạnh_mẽ ; sử_dụng lực ; khiến cho trải qua hay chịu_đựng hoặc làm cho đau_khổ hay bị tổn_thương ; hành_động bắt người bằng vũ_lực ; thực_hiện những cử_động giành lấy một_cách vội_vã ; tận_dụng hoặc chấp_nhận vì lí_do nào_đó ; làm cho ( ai đó ) phải chịu_đựng điều gì đó ; bắt một vật bằng tay ; giữ lại để tịch_thu hoặc chặn lại hay cản_trở chuyển_động của ; bắt một_cách bất_ngờ ; thúc_đẩy hoặc bắt_buộc ( một người ) phải hành_động ; ép_buộc hoặc thúc_đẩy ; chỉ_dẫn hay dùng bằng quyền_lực ra_lệnh ; bắt vào nhà_giam ; đưa ra chỉ_dẫn hay định_hướng làm việc_gì theo kiểu ra mệnh_lệnh ; cầm hoặc nắm lấy một_cách bất_ngờ ; đưa hay bắt đinh_vít vào dưới bề_mặt , như vào trong một lỗ đã khoan sẵn ; thực_hiện cử_động nắm lấy hoặc chộp lấy bằng tay ; bắt ai làm_gì ; đẩy đi , đẩy tới hoặc ép bằng lực ; tóm được cổ hay cổ áo ; bắt được bằng cách săn_bắn hay đánh bẫy ; nắm quyền_sở_hữu tạm_thời vì lí_do an_ninh hay pháp_luật
len_lách	[]
len_lỏi	di_chuyển hoặc bị bắt làm cho di_chuyển theo đường vòng_quanh , uốn_khúc hoặc đường_xoắn_ốc ; chen , lách mình vào
hú	phát ra âm_thanh chói tai ; kêu lớn , như ở động_vật ; thúc_giục bằng hò_hét ; ( động_vật ) kêu ra tiếng to một_cách tự_nhiên ; phát ra , gây ra hoặc thốt ra với một âm_thanh sâu , kéo_dài và vọng lại
ca	khoảng thời_gian làm_việc hay thực_hiện một nhiệm_vụ nào_đó ; lượng được chứa trong một ca ; tạo âm bằng giọng ; bày_tỏ bằng việc ca_hát ; thời_gian làm_việc ( sau đó sẽ có người khác đến đổi ca ) ; khoảng thời_gian xác_định mà một người phải làm_việc ( đặc_biệt là bảo_vệ ) ; đánh những âm_thanh du_dương ; liên_quan đến , dành cho , hoặc sử_dụng giọng hát ; khoảng thời_gian làm_việc ; nhóm người lao_động làm_việc trong một thời_gian cụ_thể ; đồ có tay_cầm và thường hình_trụ
danh_sách	cơ_sở_dữ_liệu chứa dãy sắp_xếp các mục theo thứ_tự ( các tên hay các chủ_đề ) ; bản liệt_kê các tên
mục	tờ giấy hay đoạn văn được chia theo hàng dọc ; phần khác_biệt có_thể được xác_định riêng_biệt trong một nhóm sự_vật mà có_thể được liệt_kê vào một danh_sách ; biên_bản của giao_dịch thương_mại ; bị hư_hỏng hoặc phân_huỷ ; thường có mùi hôi_thối ; bị hỏng do phân_rã ; do_đó không vững_chắc và vô_ích ; không ở trong tình_trạng tốt ; bị hư_hỏng hoặc phân_huỷ
chuyển_nhượng	chuyển lại thông_qua chứng_từ ; chuyển quyền_sở_hữu ; chuyển quyền_sở_hữu hoặc tài_sản ; sang_tên hoặc chuyển_nhượng tài_sản ; bán các bài báo , các chương_trình truyền_hình , hay hình_ảnh cho một_số ấn_phẩm hoặc các trạm phát_thanh truyền_hình độc_lập ; khiến cho đổi chủ_sở_hữu
phát_mại	trao_đổi hoặc chuyển_đổi ra tiền hay một vật tương_đương
vòng_tay	dây hoặc vòng được đeo quanh cổ_tay ; đồ trang_sức đeo ở cổ_tay để trang_trí
trang_sức	trang_sức ( vòng_tay , nhẫn hoặc vòng cổ ) làm từ kim_loại_quý và có nạm ngọc ( hoặc_giả ngọc )
đổ_bê_tông	phủ bằng xi_măng
chăm_sóc	chăm_nom cho mong_muốn và nhu_cầu của người khác ; cung_cấp sự chăm_nom cho ; làm_việc cho hoặc là người phục_vụ cho ; công_việc cung_cấp sự điều_trị , chăm_sóc cho ai đó hay cái gì đó ; thực_hiện chữa_trị cho cái gì đó ; đối_đãi một_cách cẩn_thận ; trông_nom hoặc săn_sóc ; đặt dưới sự xem_xét kĩ_lưỡng ; phục_vụ như một y_tá ; chăm_sóc người bị bệnh hay những người tàn_tật
kín	cấu_trúc kín như thê không thấm ; bị che giấy khỏi việc biết hay dùng chung ; ( thuộc về thông_tin ) được truyền đi một_cách bí_mật ; truyền đi một_cách bí_mật ; nằm ngoài những gì được lộ ra hay được công_khai ( đặc_biệt là bị giấu kín hay bị che_đậy một_cách cố_tình ) ; được giới_hạn cho những người cụ_thể ; có yêu_cầu phải là thành_viên mới có_thể vào ; lấy chất_lỏng ra khỏi vật chứa hay giếng
phát	phân_phối như kế_hoạch hoặc để_dành cho một mục_đích đặc_biệt ; cho một_số người ; cung_cấp ( nhưng không nhất_thiết là thức_ăn ) ; phát ; cho_phép có ; phát âm_thanh đã thu từ trước ; tiến_hành hoặc thực_hiện ; thốt ra , phát ra một_hơi ; cung_cấp hoặc ban cho , dưới dạng những phần nhỏ ; phát_triển thuận_lợi , đạt được sự giàu_có khi làm việc_gì ; lưu_hành , phân_phát hay trang_bị cho ; cung_cấp cho ( như thuốc ) ; phân_phát cho ; có như một sản_phẩm phụ ; đưa vào trong nội_dung ; phát_sóng hoặc đăng công_khai ; cho một cái phát mông ; bắt phải chịu một cái phát mông ; đánh ai , cái gì bằng tay ; tạo ra ( năng_lượng ) ; ban_tặng một_cách chính_thức ; phát ra ; cung_cấp thứ mong có hay cần đến , nhất_là sự động_viên , thực_phẩm hay phương_tiện sinh_sống ; cho hoặc cấp ( thuốc )
người_tình	người con_gái hay người phụ_nữ trẻ có quan_hệ yêu_đương với người đàn_ông ; người mà yêu ai đó hoặc được ai đó yêu ; người quan_trọng khác , người mà không có quan_hệ hôn_nhân ; người bạn chung_sống không nhất_thiết phải là vợ_chồng mà có quan_hệ tình_dục lâu_dài ; người mà được yêu bởi một người khác ; người được chọn để nhận_lời chúc_mừng vào ngày Lễ_Tình nhân
chiến_sĩ	lính nhập_ngũ thuộc lực_lượng_vũ_trang nhân_dân ; người chiến_đấu cho một lí_tưởng ; binh_lính nói_chung ; người tham_gia hoặc đã từng_trải trong chiến_tranh ; người mà chiến_đấu hoặc đang chiến_đấu
cuối	yếu_tố cuối_cùng hoặc mang tính quyết_định trong một chuỗi ; nằm ở đầu_cuối ; phần dưới cùng của các vật ; phần ở cuối hoặc thấp nhất trong một trật_tự hoặc một chuỗi ; vừa_qua ; nằm ở dưới cùng hoặc vị_trí thấp nhất ; được sử_dụng để chỉ năm thứ_tư và năm cuối ở các trường trung_học hoặc cao_đẳng ; mang tính kết_luận trong một quá_trình hoặc tiến_trình ; phần ở gần điểm giới_hạn , chỗ sắp kết_thúc ; cuối_cùng hoặc kết_thúc
đầu	trước tất_cả những thứ khác về thời_gian ; con vật_nuôi ; từ thông_tục ở Anh , chỉ cái đầu hoặc đầu_óc ; dạng tóc được chỉnh_trang ( đặc_biệt là tóc phụ_nữ ) ) ; đầu cùng của cái gì đó ; nhất_là của một thứ có mũi_nhọn ; vào lúc bắt_đầu hoặc gần lúc bắt_đầu của một khoảng thời_gian ; trước sự_kiện hoặc thời_điểm thường_lệ ; phần nhô ra của đồ_vật , có hình_dạng giống sừng ; một trong hai vị_trí đang liên_lạc với nhau ; yếu_tố đầu_tiên trong một chuỗi có_thể đếm được ; cụm dày_đặc của hoa hay cành lá ; có tính_chất xảy_ra ở lúc bắt_đầu ; có tính_chất tạo điều_kiện để bắt_đầu ; đầu_tiên trong thứ_tự sinh ; phần trên của cơ_thể con_người hoặc phần trước của cơ_thể động_vật ; bao_gồm khuôn_mặt và bộ_não ; trước tất_cả những thứ khác về thời_gian hay thứ_tự thực_hiện ; bộ_phận trên cùng của cơ_thể con_người , nơi có bộ_óc và nhiều giác_quan khác ; trước tất_cả những thứ khác trong thời_gian , không_gian hoặc mức_độ ; có tính_chất cần phải làm trước , tạo điều_kiện để thiết_lập các hoạt_động ; phần trước_nhất hoặc phần trên cùng của một_số vật ; một trong hai cực của một thứ có độ dài ; ở thứ_hạng trên tất_cả những người khác ; khối kết đặc và tròn ; người có trách_nhiệm ; phần phía trên của bất_kì cái gì ; phần nhô ra từ một đầu
cần_tây	cây thuộc họ hoa tán , cây cao mọc thẳng , có nhiều rãnh ; được trồng để chế_biến món ăn
đậu_bắp	cây họ Đậu , quả có khía và lông mịn , chứa nhiều chất nhờn , thường được sử_dụng để nấu canh chua ; quả đậu thuôn dài trông giống ngô non , vỏ có khía và lông mịn , ruột chứa nhiều hạt và chất nhờn , thường dùng nấu canh chua ; quả của cây đậu_bắp , có màu xanh , ăn được
định_kì	xảy_ra hoặc tái_diễn vào mỗi khoảng thời_gian nhất_định
bất_thường	không bình_thường , ví_dụ , về trí thông mình hoặc mức_độ phát_triển ; khác_biệt rõ_rệt từ một quy_chuẩn được chấp_nhận ; vượt lên khỏi những gì bình_thường hay tầm_thường ; rất đặc_biệt hay rất đáng chú_ý ; có khả_năng thay_đổi thường_xuyên không có lí_do rõ_ràng hoặc có sức thuyết_phục ; biến_số ; không phổ_biến hoặc không thường_xuyên bắt_gặp ; thường có số_lượng lớn hoặc nổi_bật về tính_cách hay chủng_loại ; không có quá_trình cố_định ; lệch khỏi mong_đợi thông_thường ; xảy_ra từng thời_điểm ; không xảy_ra với tốc_độ đều_đặn hoặc khoảng thời_gian cố_định ; không tuân theo những quy_luật khoa_học ; sự thay_đổi đột_ngột không_thể đoán trước ; biến_đổi và diễn ra_vào các khoảng thời_gian không đều ; không bình_thường ; không tiêu_biểu , bình_thường , theo trình_tự hoặc tuân theo một chuẩn ; chưa từng xảy_ra trước_đây
thiện_chí	có tính_chất thể_hiện ý_định , suy_nghĩ tốt và luôn thực_lòng mong_muốn đi đến kết_quả tốt khi giải_quyết việc_gì ; sẵn_sàng hay sẵn_lòng tiếp_nhận một_cách thiện_chí ; ý_định , suy_nghĩ tốt và luôn thực_lòng mong_muốn đi đến kết_quả tốt khi giải_quyết việc_gì
ác_ý	sự ác_độc do thù_hận ; cảm_giác thích_thú trước những đau_đớn gây cho người khác ; mong sự xấu_xa cho người khác ; thiếu lòng tốt
biên_cương	khu_vực gồm hai bên biên_giới hoặc ranh_giới của một nước hoặc một vùng
biên_giới	đường_thẳng hay mặt_phẳng biểu_diễn giới_hạn hay phạm_vi của một cái gì đó ; khu_vực gồm hai bên biên_giới hoặc ranh_giới của một nước hoặc một vùng ; phạm_vi bị bao_bọc ; đường biểu_thị ranh_giới
sông	dòng nước tự_nhiên lớn ( lớn hơn một chi_lưu )
cửa_sông	phần rộng của con sông , nơi nó đến gần biển ; nước_ngọt và nước_mặn hoà với nhau
tím	màu biến_đổi mà nằm trước màu xanh trong quang_phổ màu ; có màu tím
bẹp	[]
năm_âm_lịch	thời_gian của mườii hai tháng , tính theo âm_lịch
tháng_âm_lịch	thời_gian giữa những lần trăng_non liên_tiếp ( 29.531 ngày )
đỡ_đần	[]
suy_xét	nghĩ một_cách cẩn_thận ; đặt lên bàn cân ; sử_dụng đầu_óc hay khả_năng lập_luận của mình để suy_luận , quyết_định , tìm cách giải_quyết hay đánh_giá ; quá_trình suy_xét bình_tĩnh , tập_trung và dài ; cân_nhắc tới , có ý_định ; xem_xét cẩn_thận và sáng_suốt ; cân_nhắc , ngẫm_nghĩ , hay lập_luận về ; quan_sát , tìm_hiểu cẩn_thận một vấn_đề nhất_định ; thực_hiện việc xem_xét ; tính đến ; cân_nhắc để làm ví_dụ minh_hoạ ; cân_nhắc khi đưa ra một quyết_định ; sự xem_xét cẩn_trọng ; sự cân_nhắc và suy_nghĩ tập_trung
bầm	người phụ_nữ có con ( trong quan_hệ với con ) , cũng là từ để người gọi người sinh_ra mình
mệ	mẹ của bố hoặc mẹ của mẹ
dáng	một loại sản_phẩm ; loại nhất_định ( vẻ ngoài ) ; sự kết_hợp của những điểm , những đường và những mặt_phẳng tạo nên hình_dạng có_thể nhìn thấy rõ được ; đặc_điểm về dáng_điệu của người
tản_bộ	đi quanh_co với tốc_độ không cố_định ; hành_động di_chuyển bằng chân ; đi bộ để thư_giãn ; hành_động bước_đi một_cách thong_thả ( thường ở nơi công_cộng nào_đó )
sinh_vật	sinh_vật sống có khả_năng phát_triển độc_lập ; quá_trình sống và hiện_tượng đặc_trưng của những sinh_vật sống
tế_bào	tổ_chức được coi như một phần của nhóm xã_hội lớn hơn ; ( sinh_vật_học ) đơn_vị có chức_năng và cấu_trúc cơ_bản của tất_cả các cơ_thể sống ; chúng có_thể tồn_tại như những đơn_vị độc_lập của sự sống hoặc có_thể hình_thành các cụm khuẩn hay các mô như trong lớp thực_vật và động_vật bậc cao
giở_quẻ	[]
giở_chứng	[]
nhau	cấu_trúc mạch_máu trong tử_cung ở hầu_hết các động_vật_có_vú cung_cấp ô - xy , các chất dinh_dưỡng và vận_chuyển các chất_thải từ bào_thai đang phát_triển
rau	cấu_trúc mạch_máu trong tử_cung ở hầu_hết các động_vật_có_vú cung_cấp ô - xy , các chất dinh_dưỡng và vận_chuyển các chất_thải từ bào_thai đang phát_triển ; hạt , rễ , gốc , lá , củ hay thân_củ hoặc quả không ngọt của cây dạng cỏ ; cây nhiều lá hay có lá và gốc ăn được như rau ; cây thảo_mộc nào được trồng để lấy phần ăn được , như quả , rễ_củ , lá của rau chân_vịt , hạt của các cây đậu hay nụ hoa của lơ xanh và lơ trắng
đồng_tình	có khuynh_hướng tỏ_vẻ đồng_tình ; có chiều_hướng giúp_đỡ hay hỗ_trợ ; không chống_đối hay thù_địch ; đạt đến sự nhất_trí ; đạt được sự thống_nhất ; sự đồng_ý với một tuyên_bố hay đề_nghị để làm cái gì đó ; đạt đến một sự hoà_hợp về quan_điểm , cảm_giác hay mục_đích ; tán_thành như một niềm_tin
phản_đối	cưỡng lại ; không ủng_hộ ( một hành_động hay đề_xuất , v . v . ) ; hành_động đối_lập với ; từ_chối tuân theo ; hành_động chống lại hay phản_đối ; không tuân theo những tục_lệ hay những học_thuyết được lập ra , đặc_biệt về tôn_giáo ; từ_chối vì không có cơ_sở , không đúng hay không công_bằng ; ( thường theo sau bởi ` to ) chống_đối mạnh_mẽ ; hành_động thể_hiện sự không đồng_tình mạnh_mẽ ; đưa ra sự phản_đối chính_thức trong một toà_án ; phản_đối chính_thức bằng luật_pháp ; tranh_luận nhằm phản_đối hay khác_biệt về ý_kiến ; phá_bỏ các tục_lệ đã được thiết_lập ; thể_hiện rõ sự phản_đối thông_qua hành_động hay lời_nói ; được đặc_trưng hoặc thể_hiện sự phủ_định hay từ_chối ; không có tính_chất tích_cực ; đưa ra sự phản_đối ; phản_đối bỏ_phiếu ; từ_chối việc tán_thành ; cự_tuyệt sự đồng_ý ; thể_hiện hoặc đưa ra sự phản_đối , hay chỉ_trích hoặc biểu_thị sự bất_đồng quan_điểm ; thực_hiện phản_đối ; phản_đối cái gì đó mà mình không tán_thành hay đồng_ý ; thốt ra những lời phản_kháng ; xem như xấu hoặc sai ; tranh_đấu chống lại hoặc kháng_cự mạnh_mẽ ; không được kéo_dài hoặc duy_trì bằng hỗ_trợ phi vật_chất ; khuynh_hướng không chấp_nhận ai đó trong nhóm ; đặt vào thế bất_lợi ; không thích hoặc thể_hiện sự phản_đối
thanh	khối chất cứng như xà_bông hay sáp ; mỏng về chiều dày hoặc đường_kính ; ( ngôn_ngữ_học ) âm_vực hay sự thay_đổi âm_vực của giọng , có tác_dụng khu_biệt âm_thanh từ hoặc hình_vị trong những ngôn_ngữ có thanh_điệu ; thanh nằm ngang_nối hai mép thuyền của thuyền có mái_chèo , thường được sử_dụng để ngồi ; không bị mất cân_đối , hài_hoà ; gầy và cân_đối ; miếng gỗ , kim_loại , ... , được sử_dụng để làm vật cài , vật cản hay vũ_khí ; vật cứng dài , có dạng mỏng hoặc tròn , nhỏ bản ; dụng_cụ dài mỏng làm từ kim_loại hoặc gỗ
dụng_cụ	phương_tiện dùng để thực_hiện một mục_đích ; thiết_bị đòi_hỏi kĩ_năng sử_dụng hợp_lí ; đồ được dùng trong việc thực_hành nghề ; cái để thực_hiện một_số hành_động ; vật_dụng được thiết_kế để thực_hiện một_số chức_năng cụ_thể , phục_vụ một_số hoạt_động nhất_định ; cái được tạo ra để phục_vụ một mục_đích nào_đó
điệu	thứ_tự cố_định khi sắp_xếp các nốt nguyên khác_nhau trong một quãng tám ; ( âm_nhạc ) từng đợt của một dải nhịp ; sắc_thái giọng thể_hiện cảm_xúc của người nói ; một trong 24 âm_giai trưởng hoặc thứ cung_cấp phần khung về âm_điệu cho tác_phẩm nhạc ; loạt các chuyển_động được định trước trong khiêu_vũ hay trượt_băng
háo	[]
tử_trận	chết , như ở trong một trận chiến hoặc một cuộc đi săn ; mất khỏi cuộc_sống vật_chất , mất tất_cả các thuộc_tính và chức_năng cơ_thể cần_thiết để duy_trì sự sống
tiếp_sức	tiếp sinh_lực hay nâng cao tinh_thần
trù_dập	[]
trù_úm	[]
tứ_kết	vòng đấu để chọn bốn đội hoặc bốn vận_động_viên vào bán_kết
trận_đấu	việc đánh nhau giữa hai lực_lượng quân_sự ; cuộc_thi chính_thức trong đó có hai hoặc hơn hai người hay hai đội tranh_đua ; trận đấu thể_thao hay một cuộc_thi khác ; trận đấm_bốc hay vật
tình_ca	bài hát về tình_yêu hoặc sự thể_hiện tình_yêu dành cho người khác
ca_khúc	bản_nhạc ngắn có lời
báo_ân	[]
trả_thù	thực_hiện hành_động đáp trả lại , thường là lấy ơn trả ơn , lấy oán trả oán ; thực_hiện việc trả_thù với một nhận_thức sai ; trả_thù vì một lỗi_lầm hoặc một sự tổn_thương do một kẻ khác gây ra cho mình ; trị lại kẻ_thù , buộc phải chịu tai_hoạ tương_xứng với điều đã gây ra cho mình hoặc người_thân của mình ; hành_động được làm để đáp lại việc gây tổn_thương hay bực_mình ; phục_thù hoặc san bằng tỷ_số
vững_tâm	[]
vững_lòng	[]
cũ_rích	nhắc lại quá thường_xuyên ; quá quen_thuộc vì dùng nhiều ; thiếu tính độc_đáo hay tính thanh_thoát ; không còn mới nữa
mới_mẻ	khác so với ( những ) cái trước đó ; gốc và thuộc một loại chưa thấy trước đó ; mới hoàn_toàn hay nghuyên bản ; ( thuộc một chu_trình ) bắt_đầu hay xảy_ra lại ; thuộc hay tạo ra thứ gì đó mới_mẻ và khác_thường ; hay cái gì đó được tạo ra hay nghĩ ra đầu_tiên
lành	hiền_hoà và tốt_đẹp trong bản_chất hay ảnh_hưởng ; tốt cho sức_khoẻ và trí_tuệ ; không nguy_hiểm cho sức_khoẻ ; không tái_phát hoặc phát_triển ( đặc_biệt đối_với khối_u ) ; không độc_hại ; không_thể gây bệnh ; có tác_dụng nâng cao sức_khoẻ ; tốt cho sức_khoẻ ; trong điều_kiện tốt ; không có khiếm_khuyết hoặc thiệt_hại hay phân_rã ; không có vi_sinh_vật nhiễm_bệnh hoặc được áp_dụng các phương_pháp để làm cho không có vi_sinh_vật nhiễm_bệnh
kẹt	kẹp hoặc làm thâm tím ; tắc lại và không nhúc_nhích ; bị mắc hoặc bị giữ cố_định ; không có khả_năng di_chuyển xa hơn_nữa ; sự đẩy xuống
tù	vẫn giữ nguyên không hoạt_động hay đứng yên ; nơi giam_giữ những người phạm_tội đã bị kết_án ; tình_huống như bị cầm_tù ; một nơi như để giam_hãm ; ( chất_lỏng ) không di_chuyển hoặc không chảy ; tiếng_lóng trong tiếng Anh ( cũ ) chỉ nhà_tù ; chỉ góc ; từ 90 đến 180 độ ; góc lớn hơn 90 độ và nhỏ hơn 180 độ ; không được lưu_hành hay trôi_chảy
ngục	nơi giam_giữ những người phạm_tội đã bị kết_án ; tình_huống như bị cầm_tù ; một nơi như để giam_hãm ; tiếng_lóng trong tiếng Anh ( cũ ) chỉ nhà_tù
chủ_nghĩa_hình_thức	sự tuân_thủ sâu_sát những hình_thức đã được định ra hay hình_thức bên ngoài ; học_thuyết cho rằng cấu_trúc hình_thức hơn là nội_dung , cái nên được trưng ra
đức_tính	tính tốt , hợp với đạo_lí làm người
dày_cộp	[]
mỏng_tang	rất mỏng ; mỏng đến mức ánh_sáng có_thể xuyên qua
cây_trồng	thực_vật được trồng trên quy_mô lớn với mục_đích thương_mại
thầy_thuốc_nhân_dân	[]
điều_hành	cầm cái gì đó bằng tay và di_chuyển nó ; quản_lí hay điều_hành ; quản_lí hoặc trông_nom việc_gì ; chỉ_đạo hoặc điều_khiển ; các dự_án , các hoạt_động kinh_doanh ... ; hành_động thiết_lập và tổ_chức đường_lối ; quản_lí cái gì đó ; chịu trách_nhiệm về việc đưa ra và thực_thi các quy_tắc , luật_lệ ; hoạt_động quản_lí hay cố_gắng kiểm_soát cái gì đó ; chỉ_huy tiến_trình của cái gì đó ; quản_lí hoặc điều_khiển ; lên kế_hoạch và chỉ_đạo một nhiệm_vụ phức_tạp
lục_lọi	kiểm_tra kĩ_lưỡng để tìm_kiếm thứ gì đó ; lục_lọi vật sở_hữu của người khác theo cách không chính_đáng ; tìm_kiếm một_cách tuỳ_tiện ; tìm_kiếm triệt_để ; tìm_kiếm thứ cần_thiết hay mong_muốn ; hoạt_động tìm_kiếm một_cách kĩ_lưỡng để tìm ra vật hay người nào_đó ; tìm_kiếm mọi ngõ_ngách ( như đến tận đáy của một bể nước ) cái gì đó có giá_trị hay bị mất ; tìm , tìm_kiếm cái gì ; làm lộn_xộn hoặc không gọn_gàng
dáng_bộ	[]
dáng_điệu	[]
tự_do	sự_kiện kết_thúc thắng_lợi của cuộc Cách_mạng Mĩ ; cho_phép phản_ứng tự_phát ; ( bóng trong thể_thao ) không thuộc quyền_sở_hữu hoặc kiểm_soát của bất_kì cầu_thủ nào ; trạng_thái thoát khỏi sự kiểm_soát hay ảnh_hưởng của một người hay nhiều người khác ; sự tự_do lựa_chọn ; thoát khỏi sự giam_cầm ; trạng_thái không bị giam_cầm hoặc không bị làm nô_lệ ; trạng_thái không có sự ràng_buộc , hạn_chế về các mặt nào_đó ; không bị giam_cầm hay ở trong tình_trạng nô_lệ ; không bị hạn_chế hay bị kiềm_chế ; dễ thay_đổi ; không phụ_thuộc vào cửa_quyền , chính_thống hay truyền_thống ; có_thể hành_động theo ý_muốn ; không bị cản_trở ; không bị sức_ép hay sự kiềm_chế nào ngăn lại
phần_cứng	( khoa_học máy_tính ) bộ_phận cơ_học , từ_tính , điện_tử hay điện tạo nên một hệ_thống máy_tính ; phần cơ_thể cứng ( như xương , răng ) , có khả_năng chịu được tác_động từ bên ngoài và khó bị phân_huỷ hơn phần_mềm
thu_ngân	người thu tiền_của khách_hàng ( tại các cửa_hàng kinh_doanh , dịch_vụ )
dân_cư	thành_viên bản_địa hoặc nhập_tịch của một quốc_gia hay một tổ_chức chính_trị ; người sống trong một vùng lãnh_thổ hay quốc_gia ; người mà sống ở một nơi cụ_thể
cắt	ngừng quay_phim ; gặt hay thu_hoạch ; cắt với những nhát sâu ; như bằng rìu hay dao_rựa ; ngăn chuyển_động ( của cái gì ) một_cách đột_ngột ; làm cho đứt bằng máy xén ; hành_động phân_tách phần to ra những phần nhỏ hơn ; ( dùng để nói về cỏ hoặc thực_vật ) bị loại bởi một dụng_cụ cầm tay hoặc máy ; ngăn_cản sự di_chuyển của một đối_thủ hay một quả bóng ; hành_động hay quá_trình tách hoặc làm cho đứt bằng vật sắc , đặc_biệt là phẫu_thuật loại_bỏ hoặc tách mô ; tạo một vết cắt gọn qua ; tạo_mẫu và may theo một mốt nào_đó ; chia tách bằng hay như bằng một dụng_cụ ; sử_dụng một con dao để làm_gì đó ; tạo một đường rạch bằng cách khắc hoặc cắt ; vun_trồng , chăm_sóc và cắt phần sinh_trưởng ; chấm_dứt hoặc rút_gọn trước khi phần cuối của nó được mở_rộng hoặc trọn_vẹn hay phạm_vi của nó hoàn_thành ; làm đứt có hại ; làm cho đứt thành từng mảnh bằng vật sắc ; tạo một đường rạch hay sự phân_tách ; cắt hở ra ; biên_tập bằng cách lược bỏ hoặc thay_đổi các đoạn không phù_hợp ; thay_đổi hoặc làm gián đoán tính_đồng_nhất hay liên_tục ; ( đặc_biệt sử_dụng cho gỗ ) bị cắt hay xẻ theo chiều dọc miếng gỗ ; làm cho thưa bớt ; cắt bỏ các cạnh khỏi và cắt xuống đến cỡ mong_muốn ; thay_thế một góc bằng mặt_phẳng ; làm cho ngắn hoặc ngắn hơn ; được tạo_dáng hoặc được tạo_hình bằng cách cắt ; bỏ cuống các loại hoa_quả hay quả mọng ; gặp nhau tại một điểm chung ; bắt ra khỏi ; cắt nhẹ , bằng dao_cạo ; làm một phần tách ra khỏi một tổng_thể ; làm ngắn đi như bằng cách loại_bỏ phần đỉnh hoặc đuôi của cái gì đó ; cắt hoặc cắt qua bằng máy xén ; làm xấp_xỉ bằng cách bỏ_qua tất_cả hạng tử vượt quá hạng tử được chọn ; chia ra thành các phần
tẩm	làm cho chất bột hay chất đường dính lên bề_mặt thức_ăn ; tạo một lớp lên bề_mặt cái gì đó ; rưới lên , phủ lên trước khi nấu_ăn ; hành_động thấm_đẫm hoàn_toàn bằng một chất_lỏng
nghị_quyết	quyết_định đã được chính_thức thông_qua ở hội_nghị , sau khi vấn_đề đã được tập_thể thảo_luận
tài_liệu	tập_hợp các hồ_sơ liên_quan ( bằng văn_bản hoặc điện_tử ) được lưu_trữ cùng nhau ; bài viết cung_cấp thông_tin ( thường là thông_tin có đặc_tính chính_thống ) ; những bản viết_tay được xuất_bản theo một kiểu dạng nào_đó với một chủ_đề nào_đó ; tác_phẩm được viết ra ( thường là sách hoặc báo_chí ) ; thông_tin ( dữ_liệu , ý_tưởng hoặc tài_liệu quan_sát ) được sử_dụng hoặc được làm lại thành dạng hoàn_chỉnh
ăn_nhậu	[]
nhậu_nhẹt	cuộc vui_chơi rượu_chè , bữa tiệc_rượu vui_vẻ
gắn_kết	có gắn với nhau ; gắn_bó chặt_chẽ hoặc mật_thiết ; có mối liên_hệ chặt_chẽ , không tách rời ; làm cho các vật dính lại với nhau hay giảm khoảng_cách giữa chúng ; gắn chặt với nhau , không_thể tách rời ; kết lại với nhau hoặc có xu_hướng kết lại với nhau ; được sáp_nhập ; kết_nối bằng các phương_tiện truyền_thông ; làm cho chặt như_thể bằng xi_măng
liên_kết	thành_lập một liên_kết hoá_học với ; tạo ra mối quan_hệ logic hay nhân_quả ; liên_lạc với các thành_viên và trong phạm_vi một nhóm ; thêm vào từ một nguồn khác ; hành_động gắn_kết nhiều thứ lại để hình_thành tổng_thể mới ; hành_động kết_giao hay tham_gia với những người khác ; trở_thành bạn đồng_minh hoặc cộng_sự , như theo một thoả_thuận hay sự gắn_kết ; có tính_chất tham_gia và kết lại với nhau ; của một hợp_chất hữu_cơ ; có chứa hai hoặc nhiều liên_kết đôi , mỗi liên_kết đôi cách nhau bằng một liên_kết đơn ; liên_kết hoặc kết_hợp ; tham_gia vào sự liên_kết hay hoạt_động ; nắm giữ được phần_tử , chất_liệu hay vật_liệu khác trong liên_kết hoá_học hay vật_lí ; gắn_kết với nhau đặc_biệt trong cặp hay trong nhóm ; được đặc_trưng bởi sự thống_nhất ; tham_gia vào một thực_thể duy_nhất ; thiết_lập một quan_hệ hay một mối quan_hệ ; hành_động phối_hợp hay liên_kết trong một mục_đích hay niềm_tin chung ; tham_gia vì mục_đích chung hay trong sự hoạt_động chung ; đem hai vật nối lại với nhau ; đưa vào một quan_hệ chung , bổ_sung hoặc tương_hỗ ; cung_cấp cho đối_tác ; kết_hợp lại cùng một mục_đích chung ; ở trong sự kết_hợp hay hành_động kết_hợp với ; làm cho các thành_tố rời_rạc kết_nối hoặc liên_kết với nhau ; có gắn với nhau ; tạo thành một tập_đoàn ; hành_động như một người cộng_sự ; có tính_chất kết_hợp từ hai thứ trở_lên
máy_tính	máy nhỏ dùng cho các phép_tính toán_học ; máy để thực_hiện tính_toán tự_động ; máy_tính số nhỏ dựa vào bộ_vi_xử_lí và được thiết_kế để được một người sử_dụng tại một thời_điểm
bộ_vi_xử_lý	mạch_tích_hợp chứa bộ_xử_lí_trung_tâm ( CPU ) của máy_tính , thường được bố_trí trên một chip nhỏ
cải_thiện	sửa_đổi để chức_năng tốt hơn ; cải_thiện ; thay_đổi cho tốt hơn ; góp_phần vào sự phát_triển ; làm cho tốt hơn ; hành_động đặt cái gì đó vào trạng_thái hoạt_động trở_lại ; làm tăng địa_vị hay thứ_bậc ; cải_thiện một_cách đáng_kể ; đi từ xấu đến tốt ; trở_nên tốt hơn ; làm cho tốt hơn hoặc cải_thiện về chất_lượng ; dẫn_dắt hay bắt_buộc từ_bỏ một hành_động sai hay hướng đi xấu trong cuộc_sống , kiểm_điểm và sửa_đổi theo một hướng đi đúng
thuần_hoá	làm cho phù_hợp với xã_hội con_người , với đời_sống một gia_đình cụ_thể và phục_vụ con_người ; chiến_thắng tính hoang_dã của một con vật nào_đó ; khiến nó trở_nên dễ bảo và sai_khiến
năng_lực	đáp_ứng các tiêu_chuẩn , yêu_cầu thích_hợp cho một chức_vụ , vị_trí hay công_việc nào_đó ; phẩm_chất có_thể làm việc_gì đó ; sức_mạnh thể_chất , tinh_thần , tài_chính hoặc pháp_lí để thực_thi một sự_việc nào_đó ; việc sở_hữu những thuộc_tính ( nhất_là những thuộc_tính tinh_thần ) cần_thiết để làm một điều gì đó hay hoàn_thành một việc_gì đó ; đặc_trưng có khả_năng về thể_chất , trí_tuệ hoặc phương_diện pháp_lí ; tính_chất đáp_ứng đầy_đủ điều_kiện về thể_chất và tinh_thần ; mức_độ sâu_sắc về tâm_lí hoặc trí_tuệ ; trình_độ chuyên_môn hay thuộc về tâm_sinh_lí làm_nên giá_trị con_người
tột_độ	ở mức_độ lớn nhất ; cường_độ lớn nhất có_thể ; lớn nhất hay hoàn_thiện nhất hay tốt nhất có_thể ; tính_chất tốt nhất hay tối_cao nhất trong cùng một loại ; vượt xa giới_hạn về số_lượng , tổng_số hay mức_độ ; tới mức_độ không_thể hơn được ; vị_trí , mức_độ cao nhất trong quá_trình phát_triển
an_dưỡng	không chuyển_động ; ở trạng_thái nghỉ_ngơi
tĩnh_dưỡng	không chuyển_động ; ở trạng_thái nghỉ_ngơi
di_chuyển	hành_động thay_đổi vị_trí từ nơi này đến_nơi khác ; hành_động dời cái gì khỏi vị_trí và đưa nó vào vị_trí khác ; thay_đổi vị_trí ; xét cả nghĩa ẩn_dụ ; đi một đoạn ngắn đến một nơi nào_đó hoặc theo một_cách nào_đó ; thực_hiện một lượt di_chuyển trong trò_chơi ; thay_đổi hoặc di_chuyển khỏi một điểm hay một tiến_trình cố_định ; bị làm cho di_chuyển , thường bằng cách cưỡng_chế hoặc dùng áp_lực ; đi từ nơi này đến_nơi khác
dời	hành_động thay_đổi vị_trí từ nơi này đến_nơi khác ; đưa ra khỏi vị_trí hoặc mối liên_hệ thông_thường ; xê_dịch từ chỗ này sang chỗ khác ; hành_động làm thay_đổi vị_trí của cái gì đó ; loại_bỏ cái gì đó cụ_thể bằng cách nâng , đẩy hoặc lấy đi , hoặc loại_bỏ cái gì đó trừu_tượng ; hoãn lại hay trì_hoãn không cần_thiết ; thay_đổi nơi cư_trú , mối quan_hệ hay vị_trí làm_việc ; thay_đổi vị_trí , như vì mục_đích kinh_doanh , luật_pháp , giáo_dục , hay quân_sự ; làm cho thay_đổi hay dời sang một vị_trí hoặc địa_điểm mới , xét cả nghĩa_đen hay nghĩa_bóng ; dùng lực chuyển ra chỗ khác ; đi từ nơi này đến_nơi khác
ngoài	xa đường_trung_trực của một con tàu hoặc máy_bay ; ở ngoài hoặc xa trung_tâm ; từ hoặc giữa các nước ; trên hoặc phía bên ngoài của cơ_thể ; nằm ở hay thích_hợp để ngoài_trời hoặc bên ngoài của một toà nhà ; bên ngoài biên_giới lãnh_thổ và thẩm_quyền ; xảy_ra , phát_sinh hoặc nằm ngoài hoặc vượt khỏi giới_hạn hay mặt_phẳng nào_đó ; ở bên ngoài hoặc ở xa trung_tâm ; liên_quan tới , nằm trên hay gần phía ngoài hay giới_hạn ; được định_hướng ra ngoài hay có chức_năng hướng cái gì đó ra ngoài
trong	ánh_sáng có_thể truyền qua ; có_thể nhìn thấy sự xuyên qua một_cách rõ_ràng ; bên trong hoặc gần bên trong cơ_thể ; cho_phép ánh_sáng đi qua ; không có thiếu_sót , nhược_điểm hay sự không trong_sạch ; xa khỏi mép ngoài hoặc mặt ngoài ; nằm trong thân hoặc gần đường_trung_trực của con tàu hoặc máy_bay ; không có các yếu_tố liên_quan của mọi hình_thức ; hoàn_toàn trong và đẹp ; không bị làm đục hay làm mờ do cặn ; rõ_ràng và tươi_sáng ; được định_hướng hay được gắn vào trong ; có quỹ_đạo nằm giữa mặt_trời và quỹ_đạo trái_đất ; nằm hay xuất_hiện trong hoặc gần trung_tâm ; được làm sạch , không lẫn tạp_chất ; nằm bên trong hoặc thích_hợp với phía trong toà nhà ; xảy_ra , phát_sinh hoặc được định_vị bên trong một_vài giới_hạn , đặc_biệt là bề_mặt ; liên_quan hay ở mặt gần trung_tâm hay trong một không_gian nhất_định ; không có mây , sương_mù ; bên trong và hướng tới trung_tâm
cặp	tập_hợp gồm hai vật , hai cá_thể cùng loại đi_đôi với nhau thành một_thể thống_nhất ; gắn vào hay giữ chặt bằng những cái kẹp hay như với những cái kẹp ; chốt bằng gỗ được đẩy hoặc hướng vào một bề_mặt ; đơn_vị gồm vận_động_viên ném bóng và vận_động_viên bắt bóng ; đồ_dùng gồm hai thanh cứng để kẹp đồ_vật và giữ chặt lại ; hai thứ cùng loại ; mẩu gỗ hoặc kim_loại mảnh , nhỏ ( thường có đầu nhọn ) dùng để đỡ , buộc hoặc gắn các thứ ; một_đôi gồm hai người có liên_kết với nhau ; số đếm là tổng của một và một , hoặc là con_số đại_diện cho số này ; bao_gồm hoặc liên_quan đến hai bộ_phận hoặc thành_phần thường dưới dạng đôi ; cái để đồ_đạc để mang đi khi đi du_lịch ; hai người sống cùng nhau ; đồ chứa di_động dùng để đựng quần_áo ; hai người được coi là một đơn_vị ; kẹp có răng dùng để cố_định tóc của người phụ_nữ ; dụng_cụ để giữ được gắn vào bàn thợ ; có hai răng kẹp để giữ vật cần gia_công nằm yên
đôi	tập_hợp gồm hai vật , hai cá_thể cùng loại đi_đôi với nhau thành một_thể thống_nhất ; hai thứ cùng loại ; một_đôi gồm hai người có liên_kết với nhau ; số đếm là tổng của một và một , hoặc là con_số đại_diện cho số này ; có nhiều hơn một khía_cạnh hay phẩm_chất khác_nhau rõ_ràng ; bao_gồm hoặc liên_quan đến hai bộ_phận hoặc thành_phần thường dưới dạng đôi ; bao_gồm hai ( đơn_vị hoặc thành_phần hoặc yếu_tố hay hạng tử ) ; hai người sống cùng nhau ; lớn đủ cho hai ; hai người được coi là một đơn_vị
cẳng	từ thông_tục để chỉ đôi chân ; chi của người ; thường được dùng để chỉ cả chân nhưng trên thực_tế nó chỉ là phần chân ở giữa đầu_gối và mắt_cá chân ; phần chân người tính_từ đầu_gối đến mắt_cá chân
bắp_chân	phần phía sau cơ của xương ống_chân
chiến_tranh	tiến_hành xung_đột vũ_trang chống lại kẻ_thù ; gợi nhớ đến chiến_tranh hay cuộc_sống thời_chiến ; hành_động đấu_tranh giữa các bên tham_chiến
hoà_bình	không bị quấy_rối bởi xung_đột , nổi_loạn hay chiến_tranh ; tình_trạng yên_ổn , không có chiến_tranh
đau_đớn	khiến cho_hay đặc_trưng bởi sự đau_buồn hay đau_đớn ; trải qua ( cảm_xúc ) đau_thương ; có tính_chất tổn_thương ; thể_hiện sự đau_buồn hay nuối_tiếc ; khiến cho đau_đớn về thể_xác và tinh_thần ; gây khó_chịu về thể_chất ; sự đau_đớn và khổ_sở đến cực_độ ; vô_cùng đau_khổ ; đau mà thể_xác không_thể chịu nổi ; rất bất_hạnh ; đầy sự đau_khổ ; làm thấy oán_giận hay giận_dữ ; cảm_giác của cơ_thể cực_kì khó_chịu ; gây ra cảm_giác nhức_nhối hoặc cảm_giác bị kim châm ; trải qua sự buồn_bã , đau_khổ
làm_phiền	chọc_tức liên_tục hay thường_xuyên ; gây phiền_hà cho người khác , không ai thích ; quấy_rầy hoặc làm bực_mình ; gây kích_ứng hay làm phật_ý ; hành_động làm ai phải bận_tâm khi họ đang làm_việc ; hành_động quấy_rầy ai ; gây ra sự không thuận_tiện hoặc khiến cho ai không thoải_mái ; khiến cho ai phải bận_tâm khi họ đang làm_việc , như bằng câu_hỏi hoặc yêu_cầu ; gây khó_chịu ; gây phiền_hà ; quấy_rối , đặc_biệt bởi chọc_tức ; hành_động làm chen ngang ai hoặc làm xáo_trộn cái gì ; hành_động gây phiền_hà cho người khác , làm người khác phải bận_tâm ; quấy_rầy sự bình_yên
gia_tăng	trở_nên lớn hơn , rộng hơn , to hơn ; phát_triển hoặc tăng thêm ; hình_thành hoặc tích_luỹ dần ; tăng lên ; hoạt_động hoặc xu_hướng đi lên ( như trong hoạt_động kinh_doanh ) ; làm cho tăng_trưởng hoặc phát_triển ; hành_động tăng cái gì lên ; tăng kích_thước , khối_lượng hoặc tầm quan_trọng , ... ; hành_động tăng ( cái gì đó ) về kích_thước , khối_lượng , số_lượng hoặc phạm_vi ; trở_nên lớn hơn về lượng ; khiến cho lớn hơn hoặc nhiều hơn ; số_lượng được thêm vào
lạm_phát	liên_quan đến hay có khuynh_hướng làm tăng sự lạm_phát ; làm cho giá_cả tăng lên bằng cách tăng lưu_thông tiền_tệ hoặc tín_dụng
thói	cái gì đó được làm hay xảy_ra như_thế_nào ; tập_tính đã được thiết_lập ; hiểu_biết về cách người_ta thường làm một điều gì đó ; hành_vi được rập_khuôn , lặp lại nhiều lần ; những thái_độ và hành_vi đặc_trưng của một nhóm hay tổ_chức xã_hội nhất_định ; toàn_bộ những quy_định có tính_chất nghiêm_túc , theo quy_ước của xã_hội hoặc theo thói_quen , cần phải tuân theo trong giao_tiếp , ứng_xử , v . v .
thái_độ	đưa ra một quan_điểm phù_hợp với tinh_thần ; não trạng phức_hợp bao_gồm những niềm_tin , cảm_giác , giá_trị và thiên_hướng hành_động theo một_số cách nhất_định ; cách nhìn_nhận những tình_huống hay chủ_đề
mô_hình	sự mô_tả mang tính giả_thiết một thực_thể hay quá_trình phức_hợp ; bản_sao sao_chép người hoặc vật với khích thước nhỏ hơn nhiều ; vật để thể_hiện thứ gì đó ( đôi_khi trên qui_mô nhỏ hơn ) ; mô_hình như thật nhưng không đưa vào sử_dụng của một thứ nào_đó ; cấu_trúc thuộc tri_giác ; thứ được sao_chép từ cái gì hoặc được tạo ra để mô_phỏng cái gì
cấu_trúc	tổ_hợp phức_tạp có kiến_thức là các phần_tử và sự kết_hợp của các phần_tử ấy ; bộ_phận giữa các phần của cơ_thể tạo nên một sinh_vật sống ; ảnh_hưởng hoặc tham_gia vào cấu_trúc , xây_dựng ; cách xây_dựng thứ gì đó và sự bố_trí các thành_phần bên trong nó ; lập một_cách cụ_thể những công_việc dự_định , mục_tiêu trong một khoảng thời_gian nhất_định ; đặc_trưng bề_ngoài của bề_mặt có_thể sờ thấy được
mạo_danh	giả_vờ là một người nào_đó ; đôi_khi là với ý_định lừa_đảo
lừa_đảo	hành_động lừa_dối ; hành_vi lừa_gạt có chủ_định gây tổn_hại cho người khác ; đạt được điều gì đó bằng những thủ_đoạn gian_trá hoặc xảo_quyệt ; sử_dụng thủ_đoạn để đánh_lừa ai đó ( thường để lấy tiền_của họ ) ; giả_dối ; không thành_thật ; tạo ra_trò lừa_đảo ; hành_động với sự lừa_đảo ; lấy của ai đó thứ gì bằng sự lừa_gạt ; dùng xảo_thuật khiến ai đó tin điều giả_dối ; tước_đoạt bằng mánh_lới ; hành_vi lừa_đảo bằng mưu_đồ gian_lận ; lừa ai đó bằng việc không trả đủ tiền cho họ ; đe_doạ ai đó bằng cách giả_vờ để làm mình mạnh hơn dù sự_thực không mạnh như_vậy ; lừa ai đó về cái mà đáng_ra họ được hưởng , đặc_biệt là tiền ; thực_hiện hành_vi lừa_dối ; tiến_hành thủ_đoạn lừa_gạt ; ( hoạt_động tình_báo ) cố_tình đánh_lừa ; sự lừa_bịp trong cờ_bạc hoặc thuyết_phục ai đó mua tài_sản không có giá_trị ; có chủ_ý lừa_gạt
sếp	( tiếng_lóng ) người chỉ_huy , người cai_quản ; người có trách_nhiệm ; cách những phần hay những nhân_tố được sắp_xếp
lãnh_đạo	hành_động lãnh_đạo ; người mà điều_hành , hướng_dẫn hoặc truyền cảm_hứng cho người khác ; chịu trách_nhiệm
thẻ	thứ ( như cọng rơm hay đá sỏi ... ) được lấy hoặc chọn ra một_cách ngẫu_nhiên ; dụng_cụ trò_chơi bằng gỗ , nhựa hoặc ngà dùng để ghi_nhận số khấu_trừ hoặc để đặt chỗ ở các trò_chơi dùng thẻ khác_nhau ; phiến đá hoặc gỗ để khắc chữ lên ; thẻ hình đĩa nhỏ dùng thay_thế tiền khi đánh_bạc ; chứng_cứ chứng_minh một người_ở trong một tổ_chức mà hệ_thống thiết_bị nhận_dạng có_thể nhận_dạng được
kỉ_vật	vật_mang giá_trị về mặt tình_cảm
hỏi	hỏi để mong nhận câu trả_lời ; thẩm_tra một_cách kĩ_lưỡng ; đặt ra một câu_hỏi ; hỏi để biết thêm thông_tin ; đưa ra một câu_hỏi và chờ_đợi một câu trả_lời ; đưa ra yêu_cầu hoặc đòi_hỏi về một việc nào_đó đối_với một người nào_đó
đáp	trả lại bằng cái tương_tự
tản_bộ	đi quanh_co với tốc_độ không cố_định ; hành_động di_chuyển bằng chân ; đi bộ để thư_giãn ; hành_động bước_đi một_cách thong_thả ( thường ở nơi công_cộng nào_đó )
di_chuyển	hành_động thay_đổi vị_trí từ nơi này đến_nơi khác ; hành_động dời cái gì khỏi vị_trí và đưa nó vào vị_trí khác ; thay_đổi vị_trí ; xét cả nghĩa ẩn_dụ ; đi một đoạn ngắn đến một nơi nào_đó hoặc theo một_cách nào_đó ; thực_hiện một lượt di_chuyển trong trò_chơi ; thay_đổi hoặc di_chuyển khỏi một điểm hay một tiến_trình cố_định ; bị làm cho di_chuyển , thường bằng cách cưỡng_chế hoặc dùng áp_lực ; đi từ nơi này đến_nơi khác
chuệch_choạc	trạng_thái hay tình_trạng khác_biệt với các chuẩn_mực
chệch_choạc	tạo thành một góc khi hợp với đường nằm ngang hoặc thẳng_đứng ; trạng_thái hay tình_trạng khác_biệt với các chuẩn_mực
dương_gian	thuộc về trái_đất ; nơi cư_trú của con_người trên mặt_đất ( trong đối_lập với Thiên_Đường hay Địa_Ngục ) ; những lo_lắng về cuộc_đời này , khác_biệt với thiên_đàng và cái đến sau cái chết
âm_phủ	nơi trú_ngụ của linh_hồn người chết , theo tín_ngưỡng dân_gian
giải_thích	đưa ra một sự diễn_giải hoặc lời giải_thích ; biện_hộ , giải_thích , cãi cho_hay bào_chữa bằng các lí_lẽ ; tạp một nghĩa cho ; gán một ý_nghĩa cho ; làm cho rõ_ràng và dễ hiểu ; cho_biết nghĩa của sự_vật , sự_việc nào_đó ; diễn_tả bằng lời ; giải_thích hoặc cắt_nghĩa cái gì đó ; không bị nhầm_lẫn hay mơ_hồ ; làm cho rõ_ràng ; sự giải_thích về một điều không hiển_nhiên hiểu ngay được ; đưa ra sự phân_giải hay sự giải_thích mang tính biện_giải ; nói cho rõ nghĩa ; trình_bày bằng ngôn_ngữ đơn_giản và bớt các từ chuyên_môn hơn ; đưa ra lời tự bào_chữa , như trong một phiên_toà ; dòng suy_nghĩ khiến cái gì đó trở_nên hiểu được
ngấm	[]
mách	cung_cấp thông_tin nội_bộ hoặc tư_vấn
mách_nước	đưa lời gợi_ý ; cho_biết câu trả_lời cho vấn_đề bằng lời gợi_ý ; cung_cấp thông_tin nội_bộ hoặc tư_vấn
nước_lớn	quốc_gia hùng_mạnh đủ để ảnh_hưởng đến các sự_kiện trên toàn thế_giới
xuất_xứ	biến_cố mà là khởi_đầu , phần đầu hay giai_đoạn đầu của các biến_cố kế_tiếp
số_hoá	chuyển cách biểu_diễn kí_hiệu , tín_hiệu ( chữ_viết , âm_thanh , hình_ảnh , xung_điện , v . v ... ) sang dạng số ( đọc được trên máy_tính , các thiết_bị truyền_thông nói_chung )
hoá_lỏng	làm cho ( một chất_rắn ) thành dạng lỏng , như bằng cách đốt nóng ; trở_thành chất_lỏng hoặc dịch khi bị đun nóng ; trở_thành chất_lỏng ; làm cho một chất_khí hoặc hơi_nước chuyển thành một chất_lỏng
dận	đặt hoặc đè chân lên ; làm cho chìm xuống_nước ; bước lên và làm phẳng
nhấn	làm cho chạm dính vào hoặc thấm qua một chất_lỏng trong khi ăn ; dùng sức_ép hay lực ; ngâm trong dung_dịch tẩy_uế ; làm cho chìm xuống_nước ; tạo ra một vết lõm hay vết hằn ; dùng tay đè xuống , gí xuống ; tạo ra bằng việc ấn ; sự đẩy xuống ; hành_động ấn ; sử_dụng sức_ép
hơi_hướng	[]
hơi_hám	[]
cắt_giảm	loại_bỏ những thứ không mong_muốn hoặc không cần_thiết ; cắt_giảm xuống , làm giảm bớt ; dừng lại , ngưng lại ; giảm bớt ; làm giảm ; bắt ra khỏi
trừ_khử	hành_động bỏ đi một sự sắp_xếp nào_đó ; chấm_dứt , kết_thúc hoặc xoá sạch ; loại_bỏ cái gì đó cụ_thể bằng cách nâng , đẩy hoặc lấy đi , hoặc loại_bỏ cái gì đó trừu_tượng ; giết một_cách cố_ý và có chủ_định ; vứt bỏ cái gì đó trừu_tượng ; loại_bỏ ( một người có_thể trở_thành mối đe_doạ ) bằng cách sát_hại
nhạc_nhẹ	[]
cung_bậc	[]
túm_tụm	ngồi sát vào nhau hay ngồi xích lại với nhau ; tập_hợp lại thành đàn hay bầy ; tạo thành một đám ; đi cùng nhau , thường có mục_đích ; tụ_họp nhau lại thành đám đông ; kết_hợp với nhau thành một nhóm hoặc tập_hợp hay hình_thành một nhóm
quần_tụ	tụ_họp nhau lại thành đám đông
giở_mặt	không giữ được lời hứa hoặc bổn_phận ; thay_đổi về phía ngược_lại
lật_lọng	không giữ được lời hứa hoặc bổn_phận
thị_giác	cơ_quan để nhìn của người hay động_vật , giúp phân_biệt được màu_sắc , hình_dáng ; khả_năng nhìn ; năng_lực thị_giác ; tri nhận bằng các cơ_quan của mắt ; trải_nghiệm tri_giác về việc nhìn ; thuộc_tính của tầm nhìn hay thị_giác
võng_mạc	lớp màng ở phía sau nhãn_cầu , nơi hiện ra ảnh của vật
người_làm	người_làm một công_việc cụ_thể ; người chuyên làm_thuê cho tư_nhân ; người mà thực_hiện hành_động và làm các việc
dân_chơi	người tích_cực tìm_kiếm bạn tình và có vài mối tình cùng một lúc
phân_chia	hoạt_động như rào_cản ở giữa ; đứng ở giữa ; tách_biệt thành các ngăn hay mục phân_lập ; làm_việc phân cắt hay phân_chia ; sự phân_chia cho từng cá_nhân , đơn_vị theo những nguyên_tắc , quy_định , kế_hoạch chung ; tách ra thành các phần hoặc các bộ_phận ; phân_phối đồ_ăn hoặc chiến_lợi_phẩm theo khẩu_phần ; tách hoặc chia ra thành các phần ; chia thành các phần , các mảnh , hoặc các vùng ; phân_phối về mặt toán_học ; phân_phối , phân_tán hay chia ra thành từng phần ; chia thành nhiều phần cho từng cá_nhân , đơn_vị ; chia như_là một bộ_phận hay một phần của một thứ ; tạo thành các phần nhỏ ; làm cho phân_tách ra và đi theo những hướng khác_nhau ; phép phân_tích thành các phạm_trù loại_trừ nhau
phân_bổ	sự phân_chia cho từng cá_nhân , đơn_vị theo những nguyên_tắc , quy_định , kế_hoạch chung ; phân_công ( một công_việc hay chỗ ở ) ; làm cho có sẵn ; có chức_năng phân_phối , phân_bổ hoặc phân_tán ; được phân_bổ hoặc phân_phối , như trong phân_tích thống_kê ; phân_bổ thứ gì cho một người hay tới vị_trí được chỉ_định ; phân_phối về mặt toán_học ; đi khắp hoặc kéo_dài ; chiếm một vùng cố_định ; chia như_là một bộ_phận hay một phần của một thứ
xâm_nhập	thuộc chất_liệu đá ; bị ép khi tan chảy vào trong những vết rạn_nứt nằm giữa các lớp của đá khác ; xâm_nhập sâu và vào trong mọi bộ_phận ; tấn_công thâm_nhập vào địa_phận của địch ; thâm_nhập lẫn nhau ; tiến tới vượt quá giới_hạn thường ; dùng lực_lượng quân_đội hùng_hổ tiến vào lãnh_thổ của người khác với mục_đích chinh_phục và chiếm_đóng ; vào mà không được phép ; đến mà không được mời ; mang tính không trang_trọng ; đẩy vào trong ; hành_động xâm_chiếm ; hành_động xâm_lược để chinh_phục hay cướp_bóc của một đội quân ; vào đất_đai của người khác một_cách bất_hợp_pháp ; xâm_phạm tài_sản ( vô_hình hoặc hữu_hình ) của người nào_đó một_cách trái_phép , thường với chủ_ý lấy trộm hoặc thực_hiện một hành_động quá_khích ; lọt vào địa_phận địch một_cách nhanh_chóng
xuyên	đi vào hay đi qua , thường bằng việc vượt qua vật cản ; xuyên qua hay cắt vào , như bằng một con dao ; tạo một lỗ thủng ; làm cho thủng suốt từ bên này sang bên kia ; làm thành một cái lỗ bằng cách đâm thủng ; di_chuyển qua cái gì
thuộc_hạ	người mà chấp_nhận sự lãnh_đạo của người khác
người_lớn	người mà phát_triển đầy_đủ tính_cách từ khi trưởng_thành trở đi
dịch_chuyển	chuyển sang hướng khác , sự chuyển_động đó là không tịnh_tiến ; đi một đoạn ngắn đến một nơi nào_đó hoặc theo một_cách nào_đó ; sự trao_đổi của các phân_tử cùng động_năng và động_lượng qua ranh_giới giữa các lớp liền kề của một chất_lỏng hay màng_tế_bào ; thay_đổi hoặc di_chuyển khỏi một điểm hay một tiến_trình cố_định
tham_gia	trở_thành một phần của ; trở_thành thành_viên của một nhóm hay một tổ_chức ; có_mặt ở ( cuộc họp_mặt , lễ nhà_thờ , trường đại_học , ... ; quan_hệ hợp_tác giữa những người hoặc những nhóm đồng_tình chia_sẻ trách_nhiệm nhằm đạt được một mục_đích cụ_thể ; hành_động có_mặt ( tại một buổi lễ hay sự_kiện ; hành_động trở_thành thành_viên của một tổ_chức ; đăng_kí tham_gia vào một câu_lạc_bộ , một hoạt_động ; trở_thành một thành_viên tham_gia hay có liên_quan tới tổ_chức hoặc sự việc_gì ; hành_động gia_nhập vào và góp_phần của mình các hoạt_động của một nhóm ; góp_phần hoạt_động của mình vào một hoạt_động chung nào_đó ; góp_phần hoạt_động của mình vào một hoạt_động chung nào_đó ; cùng_với những người khác làm thành một nhóm ; đến và tập_hợp vì một sự_kiện cộng_đồng ; góp_phần vào hay chia_sẻ việc_gì đó ; đi vào một quy_trình
bơi	dùng mái_chèo hoặc các dụng_cụ khác điều_khiển khi chèo thuyền ; di_chuyển trong nước ; hành_động bơi ; đẩy đi với tay chèo
ngụp	di_chuyển trong nước ; bơi dưới nước ; có_vẻ như đang đi xuống ; chìm xuống dưới bề_mặt ; hay đi dưới nước
cư_dân	người được sinh_ra hay sống ở một nơi cụ_thể trong một khoảng thời_gian dài ; người_dân sống ở một vùng , một địa_bàn cụ_thể ; người sống và làm_việc trên cùng một khu_phố ; thành_viên bản_địa hoặc nhập_tịch của một quốc_gia hay một tổ_chức chính_trị ; người sống trong một vùng lãnh_thổ hay quốc_gia
người_dân	thành_viên bản_địa hoặc nhập_tịch của một quốc_gia hay một tổ_chức chính_trị ; người_dân bình_thường nói_chung ; nhóm người nói_chung ( đàn_ông , phụ_nữ hay trẻ_em ) ; số_lượng lớn các công_dân của một bang hay một nước ; người sống trong một vùng lãnh_thổ hay quốc_gia
khoan_thai	không vội_vàng hay chịu sức_ép ; không vội_vàng , hấp_tấp và cẩn_thận
ung_dung	không vội_vàng hay chịu sức_ép ; không vội_vàng , hấp_tấp và cẩn_thận ; thư_thái , không vội_vàng , có_thể chờ_đợi sự trì_hoãn được ; sống thong_thả , vô_trách_nhiệm , hoặc tự_do
xe_tải	phương_tiện vận_chuyển được sử_dụng để chở hàng ; xe có động_cơ phù_hợp cho việc chuyên_chở
nóc	chỗ cao nhất ; bề_mặt trên đỉnh của vùng được che_phủ hay một không_gian rỗng ; vật bảo_vệ bao_phủ phía trên đầu của xe có động_cơ ; điểm_cao nhất của cái gì đó ; vùng lồi hay hệ sọc tự_nhiên dài và hẹp
mùa_đông	có đặc_điểm hoặc hay diễn ra_vào mùa_đông ; mùa lạnh nhất trong năm , kéo_dài từ đông_chí đến xuân_phân ; ở bán_cầu Bắc
đông_chí	ngày 22 tháng 12 hàng năm , khi mặt_trời ở điểm cực Bắc
lạc_hậu	xưa
tiên_tiến	đặt ở vị_trí phía trước hoặc đi trước ; có tầm ảnh_hưởng và sức_mạnh vượt_trội ; đi trước thời_đại ; có sự phát_triển và văn_hoá ở mức cao trên cả hai phương_diện xã_hội và công_nghệ ; ( xã_hội ) phát_triển một_cách tích_cực
chọc_ghẹo	làm_phiền liên_tục ; chế_nhạo hay trêu_chọc bông_đùa ; làm cho giận_dữ ; gây phiền_hà ; quấy_rối , đặc_biệt bởi chọc_tức
biếu_xén	trả tiền để nhận được sự giúp_đỡ
nền	giả_định căn_bản mà từ đó cái gì đó được bắt_đầu , phát_triển , tính_toán hay giải_thích ; phần quan_trọng nhất hoặc cần_thiết nhất của cái gì đó ; đối_tượng tri_giác tương_đối đồng_nhất đằng sau hình_vẽ được tập_trung chú_ý ; mặt_bằng mà trên đó người và các động_vật khác di_chuyển ; bề_mặt nhô lên theo phương nằm ngang ; ( nghệ_thuật ) bề_mặt ( tường hoặc vải bạt ) dùng để chuẩn_bị thuốc màu cho tranh vẽ ; được sử_dụng như hay tạo thành một lớp nền ; phần của một cảnh ( hay một bức hoạ ) nằm sau những vật_thể ở tiền_cảnh ; nền đất hoặc đá lót đường hoặc đường_ray tàu_hoả ; chiều_cao của mặt_đất mà trên đó cái gì đó đứng lên ; bề_mặt ngang phía dưới ở bên trong ( như của phòng , hành_lang , lều , hoặc cấu_trúc khác ) ; bề_mặt thấp nằm bên trong một cấu_trúc rỗng ; thiết_bị chịu được trọng_lượng của thứ khác ; cấu_trúc cảnh dựng vẽ nên để thể_hiện một nơi cụ_thể ; khối chất_rắn thường có mặt_phẳng hoặc hình_chữ_nhật ; phần đáy hay phần thấp nhất
cận_cảnh	phần của một cảnh_gần người nhìn
sư_tử	cung hoàng_đạo thứ_năm ; mặt_trời ở cung này từ khoảng 23 tháng Bảy đến 22 tháng Tám
lăng_kính	thiết_bị quang_học có dạng_hình tam_giác , được tạo nên từ kính hoặc thạch_anh ; dùng để làm lệch chùm ánh_sáng hoặc đảo_ngược hình_ảnh ; ( phép ẩn_dụ ) phương_tiện cho_phép nhìn thấy hay hiểu được điều gì đó
bẫy	bắt bằng bẫy hoặc như_thể bằng một cái bẫy ; cái gì đó ( thường hấp_dẫn nhằm đánh_lừa ) rập mình một_cách bất_ngờ ; lôi_kéo và làm mắc_kẹt ; dụng_cụ thô_sơ để lừa bắt , giết loài vật ; một vật được bố_trí sẵn , làm nạn_nhân bị vướng vào hoặc bị cám_dỗ ; vật có chức_năng thu_hút , dụ_dỗ cái gì tới hoặc lao vào nó ; dụng_cụ trong đó cái gì đó ( thường là động_vật ) bị bắt và nhốt ; tóm hoặc bắt như bằng một cái lưới hay cái bẫy ; đặt vào một vị_trí hạn_chế hoặc gây lúng_túng
cạm	cái gì đó ( thường hấp_dẫn nhằm đánh_lừa ) rập mình một_cách bất_ngờ ; dụng_cụ thô_sơ để lừa bắt , giết loài vật ; một vật được bố_trí sẵn , làm nạn_nhân bị vướng vào hoặc bị cám_dỗ ; vật có chức_năng thu_hút , dụ_dỗ cái gì tới hoặc lao vào nó ; dụng_cụ trong đó cái gì đó ( thường là động_vật ) bị bắt và nhốt
nhảy_múa	hình_thức nghệ_thuật của giao_tiếp phi ngôn_ngữ ; nhảy , nhảy lên hoặc di_chuyển lên xuống , hay di_chuyển từ bên này sang bên kia ; thực_hiện một loạt các bước nhịp_nhàng theo đúng nhạc
nhẩy_múa	[]
minh_oan	xoá_bỏ một cáo_buộc ; làm rõ sự buộc_tội hay nghi_ngờ bằng những bằng_chứng thuyết_phục ; giải_oan nhờ tìm ra chứng_cứ ngoại_phạm
phá_vây	hoạt_động quân_sự giúp quân_bị bao_vây xông ra khỏi vị_trí của mình
nguyên_nhân	cái có tác_dụng chi_phối , thúc_đẩy hành_động , tạo cơ_sở để tin_tưởng ; sự_việc là nguồn_gốc của thứ gì đó hoặc sản_sinh ra cái gì tiếp_theo đó
nguyên_do	sự_việc là nguồn_gốc của thứ gì đó hoặc sản_sinh ra cái gì tiếp_theo đó ; thực_thể tạo ra kết_quả hoặc là nguyên_nhân của kết_quả đó hay sự_việc đó
dữ	bị kích_động mãnh_liệt và hỗn_loạn
hiền	hiền_hoà và tốt_đẹp trong bản_chất hay ảnh_hưởng ; rất ngoan_ngoãn ; có tính_cách cởi_mở và vui_vẻ
phần_phụ	phần tham_gia vào phần_lớn hơn
bộ_phận	ảnh_hưởng chỉ đến một phần hay vùng giới_hạn của cơ_thể ; phần làm_nên một tổng_thể ; đơn_vị có cấu_trúc và chức_năng hoàn_toàn riêng_biệt ở cơ_thể động_vật chuyên về một chức_năng đặc_biệt nào_đó ; phần riêng_biệt của một tổng_thể ; một trong nhiều phần mà một cái gì đó được chia thành và cùng nhau tạo nên một chỉnh_thể ; đơn_vị hành_chính trong chính_phủ hoặc doanh_nghiệp ; cái được xác_định trong mối quan_hệ với cái khác bao_hàm nó ; yếu_tố , bộ_phận kết_hợp với những yếu_tố , bộ_phận khác để tạo nên một chỉnh_thể ; đặc_biệt là phần có_thể được tách khỏi hoặc gắn với hệ_thống ; phần nhỏ có_thể được xem như tách riêng với tổng_thể
anh_dũng	quyết_tâm đối_mặt với nỗi đau , nguy_hiểm hay nghịch_cảnh ; có hoặc thể_hiện những phẩm_chất phù_hợp với một người anh_hùng ; không biết sợ và không e_ngại việc_gì kể_cả việc người khác không dám làm ; sẵn_sàng đối_mặt với hiểm_nguy
dũng_mãnh	[]
buôn_bán	thực_hiện hoạt_động bán hàng ; giao_dịch ( mua và bán ) có mục_đích cung_cấp các mặt_hàng ( hàng_hoá và dịch_vụ ) ; kinh_doanh hoặc buôn_bán một mặt_hàng ; được bán ở mức giá cố_định hay trong những điều_kiện nhất_định ; tham_gia vào kinh_doanh ; làm kinh_doanh ; rao bán để kiếm tiền sinh_sống
vận_tải	xê_dịch thứ gì hoặc ai đó ; thường qua một khoảng_cách dài ; mang chuyển từ nơi này đến_nơi khác ; vận_chuyển thương_mại ; vận_chuyển hàng_hoá mang tính thương_mại ; hoạt_động kinh_doanh thương_mại của việc chuyển hàng_hoá hay vật_liệu ; chuyển cái gì từ nơi này đến_nơi khác
khấp_khểnh	địa_hình không bằng_phẳng ; gây ra hoặc được đặc_trưng bởi những xóc nảy hoặc chuyển_động bất_thường ; không bằng nhau hoặc đồng_nhất như ở hình_dạng hoặc kết_cấu
gập_ghềnh	địa_hình không bằng_phẳng ; gây ra hoặc được đặc_trưng bởi những xóc nảy hoặc chuyển_động bất_thường ; không bằng nhau hoặc đồng_nhất như ở hình_dạng hoặc kết_cấu ; không bằng_phẳng , chỗ cao chỗ thấp
đâm_sầm	gây ra một âm_thanh lớn bất_ngờ ; chuyển_động gây ra âm_thanh đổ_vỡ ; sụp xuống hoặc đổ xuống với lực rất mạnh ; bị hư_hỏng hoặc bị phá_huỷ do sự va_chạm ; đánh hay lao vào với một lực rất lớn ; tiếp_xúc đột_ngột với cái gì
phóng	di_chuyển nhanh và mạnh ; bay lên rất nhanh ; di_chuyển một_cách đột_ngột hoặc rất mạnh ; hành_động di_chuyển vội_vàng ; đưa thuốc nạp ra khỏi ; chiếu lên một màn_hình ; dùng vũ_khí bắn tên_lửa ; đẩy lên bằng lực ; bắn về phía trước , như_thể từ một máy phóng ; chạy hay di_chuyển rất nhanh hoặc vội_vã ; di_chuyển với tốc_độ cao ; ném , gửi hoặc quăng về phía trước ; di_chuyển nhanh theo đường_thẳng ; đổ về phía trước hay thoát ra ; tung xúc_xắc , như trong trò_chơi xúc_xắc ; phát ra bất_ngờ , mạnh_mẽ và nhanh_chóng ; làm cho cái gì chuyển_động xuyên qua lực cản lớn của không_khí ; di_chuyển với tốc_độ bất_ngờ ; làm cho lớn hơn
bò	sự di_chuyển rất chậm_chạp ; trâu_bò hoang chi Bò hoặc họ_hàng gần với Bibos ; thành_viên thuộc chi Bò ; động_vật chi Bò được nuôi thành đàn không phân_biệt giới_tính hay năm_tuổi ; di_chuyển chậm với thân mình đặt gần sát hoặc sát mặt_đất ; phát_triển hoặc lan_rộng ; thường theo cách để bao_phủ ( một bề_mặt ) ; cách di_chuyển chậm_chạp bằng hai tay và đầu_gối ; vải bông , dệt thô có độ bền cao
đi	di_chuyển đến , chuyển_động về phía ai , cái gì hay tiến gần đến ai , cái gì ; đưa ( một lá bài hay quân bài ) vào chơi trong một ván , hoặc hành_động một_cách chiến_lược như trong một ván bài ; đi khỏi từ một nơi này sang nơi khác ; sử_dụng hay di_chuyển ; di_chuyển bằng một phương_tiện giao_thông , hoặc theo một tuyến đường nhất_định ; làm cho thứ gì đó đi qua hay đưa đến_nơi nào_đó ; đi qua khó_khăn hoặc chướng_ngại_vật ; đi hay đi qua một quãng đường ; ( tàu_xe ) có trạng_thái nào_đó khi lái ; đi bằng máy_bay , xe_buýt , tàu_hoả v . v . ; lái_xe ; thay_đổi vị_trí ; xét cả nghĩa ẩn_dụ ; đi qua hoặc đi ngang qua bằng việc đi bộ ; đi trên , đi dọc theo hoặc đi qua ; trải qua sự chuyên_chở như bằng một phương_tiện vận_tải ; đi khỏi một nơi nào_đó ; đi được một đoạn đường cụ_thể ; đi hoặc được vận_chuyển bằng xe ; ngồi trên và điều_khiển phương_tiện đi_lại ; thực_hiện một lượt di_chuyển trong trò_chơi ; mất khỏi cuộc_sống vật_chất , mất tất_cả các thuộc_tính và chức_năng cơ_thể cần_thiết để duy_trì sự sống ; trải qua thời_gian trong tù hay trong trại_cải_tạo ; sử_dụng chân để tiến lên ; tiến lên bằng các bước ; ngồi trên lưng một con vật , thường trong khi điều_khiển chuyển_động của nó ; di_chuyển bằng xe hoặc đi bằng xe ; hành_động đi ; di_chuyển do chịu lực đẩy ; đi khỏi hoặc rời khỏi ; di_chuyển qua cái gì ; trải qua một trình_tự hoặc đi theo một tiến_trình ; thực_hiện một chuyến đi đến một địa_điểm nhất_định ; đi từ nơi này đến_nơi khác
yểm_hộ	bảo_vệ hoặc phòng_thủ ( một vị_trí trong một trận đấu )
yểm_trợ	[]
vòng_vòng	[]
ngoại_tiếp	[]
nội_tiết	thuộc hoặc thuộc về tuyến_nội_tiết hoặc chất tiết của chúng
luồng	dòng_chảy hoặc sự thông khí mà không bị chặn ; số_lượng vật_thể nhỏ bay qua không_khí ; tiến_trình chi_phối của các sự_kiện hay những ý_tưởng liên_tiếp
dị_ứng	phản_ứng quá mẫn_cảm với một chất gây dị_ứng cụ_thể ; các triệu_chứng có_thể khác_nhau nhiều tuỳ theo mức_độ
lương_tri	[]
trẩy_hội	[]
ứng_chiến	[]
vặn	tạo thành một dạng xoắn_ốc ; tạo thành vòng xoắn ; kết lại với nhau , như bằng cách bện , kết hay vặn ; xoắn hay nén ; xoay như xoay chiếc đinh_vít ; mân_mê cái gì đó , thường_khi trong tâm_trạng lo_âu hay vô_thức ; việc quay hoặc xoay xung_quanh ( tại_chỗ ) ; chuyển_động sang một hướng khác ; làm cho chuyển_động xung_quanh hoặc xoay quanh ; hoàn_thành bằng việc quay ; điều_chỉnh cái gì bằng cách sử_dụng tay làm cho nút điều_khiển chuyển_động theo đường vòng ; đưa hay bắt đinh_vít vào dưới bề_mặt , như vào trong một lỗ đã khoan sẵn ; khiến cho cái gì xảy_ra một_cách khó_khăn hoặc cực_nhọc ; xoắn , ép hay nén để làm chất_lỏng chảy ra
vặn_vẹo	uốn qua uốn lại , nghiêng_ngả theo nhiều hướng khác_nhau ( đặc_biệt khi đang vật_lộn ) ; xoắn và ép khiến cho không còn giữ được hình_dạng ban_đầu ; khiến cho cái gì xảy_ra một_cách khó_khăn hoặc cực_nhọc
lùng_bùng	[]
vắng_ngắt	[]
chê	đối_xử hay nói_năng với sự coi_thường ; công_kích quyết_liệt và nặng_nề ; tìm ra lỗi bằng cách chỉ ra những lỗi có thật hoặc bịa ra
khen	thể_hiện sự tán_thành ; nói với ai đó điều gì để thể_hiện sự ca_ngợi ; khích_lệ và động_viên bằng phần_thưởng ; thể_hiện một ý_kiến tốt đối_với ai hoặc cái gì đó ; được ban cho_hay đáng được nhận sự đền_bù theo những giá_trị hay công_trạng ; thể_hiện sự khen_ngợi
tượng_đài	[]
bảng_tổng_sắp	danh_sách theo thứ_tự các điểm_số hay những kết_quả cho thấy những vị_trí tương_đối của những đối_thủ ( cá_nhân hay đội ) trong sự_kiện thể_thao
người_yêu	người là người_yêu của một cô_gái hay một phụ_nữ ; người con_gái hay người phụ_nữ trẻ có quan_hệ yêu_đương với người đàn_ông ; người mà yêu ai đó hoặc được ai đó yêu ; người quan_trọng khác , người mà không có quan_hệ hôn_nhân ; người mà được yêu bởi một người khác ; người được chọn để nhận_lời chúc_mừng vào ngày Lễ_Tình nhân ; người được yêu_thương đặc_biệt
tình_nhân	người con_gái hay người phụ_nữ trẻ có quan_hệ yêu_đương với người đàn_ông ; người mà yêu ai đó hoặc được ai đó yêu ; người quan_trọng khác , người mà không có quan_hệ hôn_nhân ; người bạn chung_sống không nhất_thiết phải là vợ_chồng mà có quan_hệ tình_dục lâu_dài ; người mà được yêu bởi một người khác ; người được chọn để nhận_lời chúc_mừng vào ngày Lễ_Tình nhân
thiện_cảm	[]
ác_cảm	khuynh_hướng không chấp_nhận ai đó trong nhóm
trau_chuốt	ăn_mặc và chải_chuốt với sự quan_tâm tỉ_mỉ như cho một dịp đặc_biệt ; nâng_cấp hoặc làm cho hoàn_hảo nhờ tỉa_tót hoặc đánh_bóng ; làm_việc một_cách chi_tiết ; thái_độ màu_mè ; thêm các chi_tiết cho một bản kê_khai hay một ý_tưởng nhằm làm rõ nghĩa cùng_với đó là diễn_giải theo cách đã học ; thường là bằng văn_bản
phát_triển	biến_đổi dưới các điều_kiện thúc_đẩy của việc_làm cho biến_đổi ; có sự thay_đổi hoặc trải qua sự thay_đổi ( thể_chất hoặc thuộc_tính ) ; khai_triển bằng việc phát_triển một ý_tưởng âm_nhạc và bằng cách tạo ra sự thay_đổi giai_điệu và hài_hoà trong chủ_đề ; trở_nên lớn hơn , rộng hơn , to hơn ; phát_triển hoặc tăng thêm ; di_chuyển về phía trước , hiểu theo cả nghĩa ẩn_dụ ; khiến cho phát_triển và phân_hoá thuận theo lẽ phát_triển tự_nhiên của nó ; phát_triển , tiến_bộ , nảy_nở hoặc tiến_hoá qua một quá_trình tiến_hoá , phát_triển tự_nhiên hoặc một môi_trường có lợi ; hành_động cải_thiện bằng cách mở_rộng hay cải_tiến ; làm cái gì trở_nên tốt hơn , thực_hiện ở quy_mô lớn hơn ; tăng về kích bởi một quá_trình tự_nhiên ; trở_nên lớn hơn về kích_thước , thể_tích hoặc số_lượng ; dần_dần tạo ra ; ở trong trạng_thái tồn_tại ; thành hình_dạng hay hình_dáng ; cái đang lớn lên hoặc đã lớn rồi ; mang đi xa hơn hoặc tiến lên ; hành_động mở_rộng qui_mô , phổ_biến rộng_rãi cái gì ; làm cho tăng_trưởng hoặc phát_triển ; phát_triển theo hướng tích_cực ; có sự phát_triển và văn_hoá ở mức cao trên cả hai phương_diện xã_hội và công_nghệ ; được tăng lên về mức_độ , kích_cỡ , khối_lượng hay quy_mô ; hành_động tăng ( cái gì đó ) về kích_thước , khối_lượng , số_lượng hoặc phạm_vi
gươm	vũ_khí có tay_cầm và lưỡi sắc nhọn ; vũ_khí chém hoặc đâm có lưỡi kim_loại dài và một cán có đồ bảo_vệ tay
lưỡi	phần nhô ra dài , mảnh và sắc của vật ; phần phẳng của một công_cụ hay một loại vũ_khí ( thường ) có mặt_cắt ; lưỡi của một_số động_vật nhất_định , được sử_dụng như thịt ; khối thịt mềm trong miệng , bao_phủ bởi lớp màng_nhầy , dùng đề đón nếm thức_ăn
bánh_xe	thiết_bị đơn_giản gồm khung tròn với các nan_hoa có_thể quay tròn trên một trục ( như ở phương_tiện giao_thông hoặc các loại máy khác ) ; bánh_xe , cái mà có vành , lốp và bọc đùm ; sử_dụng cho xe ô_tô
vành	phần ngoài của bánh_xe , nơi lốp xe được cố_định vào đó ; vòng_tròn bao quanh miệng hay ở phần ngoài cùng của một_số vật để cho cứng , cho chắc ; phần nhô ra của vật gì để giúp cho vật đó chắc_chắn hơn hoặc dùng để gắn vào một vật khác ; ( giải_phẫu_học ) cấu_trúc bao quanh hoặc giống với đai
tượng_đài	[]
phân_bón	mọi chất như phân hoặc hỗn_hợp của nitrat được sử_dụng để làm cho đất màu_mỡ hơn ; mọi chất từ động_vật hay thực_vật được sử_dụng để bón cho đất , đặc_biệt là phân động_vật thường kèm với rác
nạc	[]
búi	tập_hợp thành khối hình chuỳ ; tóc được cuộn gọi gàng sau gáy ; túm hoặc một mớ nhỏ ; sự kết_hợp trong tổng_thể của nó ; cụm lông_vũ hoặc lông tóc hoặc cỏ
khung_thành	thiết_bị trò_chơi là vị_trí đích mà người chơi cố đưa bóng vào để ghi_điểm
cầu_môn	thiết_bị trò_chơi là vị_trí đích mà người chơi cố đưa bóng vào để ghi_điểm
kĩ	chu_đáo một_cách chặt_chẽ ; khắt_khe và nghiêm_ngặt ; được phát_triển và thực_hiện với sự quan_tâm và ở từng chi_tiết nhỏ ; đánh_dấu bởi sự tuân theo chính_xác các chi_tiết
sơ_sài	nhỏ không đáng_kể ; một vấn_đề chỉ ở hình_thức ( ` tokenish là từ dùng thân_mật ) ; nhỏ về số_lượng ; thiếu sự phong_phú hoặc số_lượng ; thiếu về số_lượng , chất_lượng hoặc quy_mô
buồn	bị ảnh_hưởng hoặc cảm_thấy xuống tinh_thần ; về những điều mà khiến bạn cảm_thấy buồn ; gây ra sự chán_nản ; gây cảm_giác buồn u_ám và thiếu_hụt ; thấy buồn ; có tâm_trạng chán_nản , không vui , không hứng_thú với thứ gì vì vừa trải qua những việc đau_thương hoặc không như_ý ; có tính_chất khiến cho người khác cảm_thấy chán_nản ; không trải qua hay không làm hứng_thú ; cảm_giác thuộc về thể_xác như bị nhiều gai nhỏ châm ; làm cho không vui ; gây ra nhàm_chán
vui	cảm_thấy hạnh_phúc hoặc vui_vẻ ; trở_nên vui_vẻ ; tràn_đầy hay thể_hiện sự vui_vẻ ; thể_hiện niềm_vui hoặc có phẩm_chất tạo ra niềm_vui và sự thích_thú , đặc_biệt là làm cho người khác hạnh_phúc ; có tính_chất gây cười ; có cảm_giác vui_vẻ với cái gì ; tràn_đầy hay tạo ra niềm_vui ; cảm_nhận được hạnh_phúc ; đầy sự vui_vẻ ; thể_hiện tinh_thần tốt ; cuốn_hút theo cách dễ_chịu , thú_vị hoặc vui_vẻ ; hạnh_phúc và tràn_đầy năng_lượng ; thấy có niềm_vui
nhược_điểm	nhược_điểm hoặc sự thiếu_sót ; chỗ kém , chỗ yếu ; điều còn thiếu , còn có sai_sót hay điểm yếu
ưu_điểm	có đặc trứng là tính thế có lợi cho cạnh_tranh ; đặc_điểm , tính_chất vượt_trội đáng ngưỡng_mộ ; đặc_tính nổi_bật ; điểm xuất_sắc của điều gì đó hay ai đó
quan_hệ	trạng_thái tương_tác qua_lại giữa nhiều người , các nhóm , hay các quốc_gia ; có mối quan_hệ nào_đó với nhau ; cách hai cá_nhân gắn_kết với nhau ; sinh_hoạt tình_dục ; ( thường ở dạng số_nhiều ) người có tầm ảnh_hưởng mà mình quen_biết ( quan_hệ gia_đình hoặc bè_bạn ) ; có liên_quan hay quan_hệ ; có quan_hệ hoặc thiết_lập mối quan_hệ với ; ( thường là số_nhiều ) sự giao_thiệp hoặc liên_hệ lẫn nhau giữa những người hoặc những nhóm người ; hoạt_động tình_dục giữa hai người ; thực_hiện hoạt_động tình_dục
trạng_thái	nhận_thức hay khía_cạnh nhất_định về một tình_huống ; trạng_thái hoặc vị_trí mà bạn thấy mình ; phương_thức hay hình_thức tồn_tại của một người hoặc vật ; cách mà thứ gì đó liên_quan tới thuộc_tính cơ_bản của nó ; trạng_thái tại một thời_điểm cụ_thể ; tình_trạng chung của sự_vật ; sự kết_hợp của hoàn_cảnh tại một thời_điểm nhất_định ; sự khó_khăn phức_tạp , nguy_kịch hay bất_thường
đong_đưa	di_chuyển qua_lại hoặc sang hai bên , có sự đảo_đi_đảo_lại ; khiến cho di_chuyển qua_lại ; khẽ đu_đưa lên xuống
vung_vẩy	di_chuyển qua_lại hoặc sang hai bên , có sự đảo_đi_đảo_lại
bừa_bãi	tự_do , tuỳ_tiện , không theo khuôn_phép ; không gọn_gàng và ngăn_nắp ; không được sắp_xếp theo thứ_tự ; thiếu kỉ_luật đạo_đức ; đặc_biệt là không soát bản_thân ; nổi_bật bởi sự cẩu_thả nghiêm_trọng ; bẩn_thỉu và mất trật_tự ; có sự sắp_xếp không theo trật_tự ; mang đến sự lộn_xộn cho ; không chọn_lựa cẩn_thận theo một loại hay người nào_đó ; thiếu ngăn_nắp hoặc trật_tự ; không có kỉ_luật và hết_sức lộn_xộn ; thiếu kỉ_luật hoặc sự kiểm_soát
gọn_ghẽ	có sự chuẩn_bị hoặc bố_trí theo một trật_tự nhất_định ; trạng_thái của sự sắp_đặt hay vẻ bề_ngoài
nghiêm_lệnh	[]
đồng_dao	[]
nhà_thơ	người chuyên sáng_tác thơ và đã có tác_phẩm có giá_trị được công_nhận ; người sáng_tác thơ ; người có năng_lực sử_dụng hoặc sáng_tạo ngôn_từ mang lại hiệu_quả nghệ_thuật cao
thi_nhân	người chuyên sáng_tác thơ và đã có tác_phẩm có giá_trị được công_nhận ; người sáng_tác thơ
máy_tính	máy nhỏ dùng cho các phép_tính toán_học ; máy để thực_hiện tính_toán tự_động ; máy_tính số nhỏ dựa vào bộ_vi_xử_lí và được thiết_kế để được một người sử_dụng tại một thời_điểm
vi_xử_lý	mạch_tích_hợp chứa bộ_xử_lí_trung_tâm ( CPU ) của máy_tính , thường được bố_trí trên một chip nhỏ
né_tránh	lẩn_tránh vấn_đề , hoặc xem là đương_nhiên , không cần nói thêm ; tránh hay cố_tình trốn_tránh việc thực_hiện , trả_lời hay trình_bày ( bổn_phận , câu_hỏi hay các vấn_đề ) ; tránh sự_thật từ một quan_điểm hay câu_hỏi nào_đó bằng việc nêu lên những sự phản_đối không liên_quan nhằm đánh_trống_lảng ; tránh không muốn xử_lí việc_gì ; trốn về thể_xác hoặc về tinh_thần ; tạo sự di_chuyển đột_ngột theo một hướng mới để tránh ; cố tránh đi để khỏi phải gặp cái gì hay phải thực_hiện việc_gì , đặc_biệt theo một_cách khó hiểu
hích	thúc khuỷu tay vào mạng_sườn của một người khác ; đẩy nhẹ , thường để đùa_vui ; tạo sự chuyển_động về phía trước ; làm cho chuyển_động theo một hướng nào_đó bằng một lực tác_động thẳng tới , hay tạo lực để di_chuyển cái gì ; cử_chỉ tay được đưa ra nhanh và dứt_khoát ( giống một cú đánh ) ; hành_động đẩy ; sử_dụng lực mạnh để làm cái gì di_chuyển ; tác_dụng lực đẩy lên ai , cái gì một_cách thô_bạo
địch	không thuộc về quân_đội của nước mình hay quân đồng_minh
ta	[]
lưu_thông	phát_tán hay truyền đi cái gì đó đến một nhóm hay khu_vực lớn hơn ; di_chuyển qua một không_gian , mạch hay hệ_thống , quay trở_về điểm xuất_phát
ách_tắc	[]
thứ_yếu	không thuộc tầm quan_trọng chính ; có tầm quan_trọng , tầm_cỡ hay cấp_bậc thấp hơn ; giới_hạn về kích_cỡ hay phạm_vi
rộng_rãi	sẵn_sàng chia_sẻ hoặc cho ; thể_hiện hoặc đặc_trưng bởi có tư_tưởng phóng_khoáng ; khuynh_hướng tôn_trọng quan_điểm và niềm_tin khác với riêng bạn ; diện_tích hoặc khoảng_cách lớn và không bị phân_tách ; to_lớn và rộng_rãi ; rất rộng_rãi ; không nhỏ_nhặt trong tính_cách và tư_tưởng ; rộng_lớn về phạm_vi không_gian , tầm xa hay số_lượng ; rộng về quy_mô ; phát_triển hay xuất_hiện ở nhiều nơi của thế_giới ; có hoặc cho_phép một không_gian đủ rộng ; ( thuộc về nhà và các phòng ) có không_gian rộng
đặt_chân	đặt_chân xuống hoặc nhấn chân , đặt bàn_chân ; tới một địa_điểm , dù là thực hay trong tưởng_tượng
thay	chuyển từ một phương_tiện giao_thông này sang một phương_tiện giao_thông khác ; bỏ đi , từ_bỏ hoặc bỏ để chuyển sang một cái khác ; đặt một người hoặc một vật vào chỗ của cái gì hoặc của người nào_đó ( thường là người hay vật làm_việc không hiệu_quả , bị hỏng hoặc mất , không còn hoạt_động như mong_đợi ) ; hành_động thay_đổi cái này hay vị_trí này thành cái khác , vị_trí khác ; hành_động đặt một vật hay một người vào vị_trí của vật hay người khác ; trở_thành vật thay_thế hoặc người thay_thế ; xoá_bỏ và thay_thế cái gì ; đặt vào vị_trí của một cái khác ; đổi chỗ những vật có chức_năng tương_đương nhau ; hành_động thay_đổi cái này thành cái khác , vị_trí này thành vị_trí khác ; đảm_nhiệm vị_trí của
dì_ghẻ	chồng sau của mẹ hoặc vợ sau của bố ; người phụ_nữ là vợ trong cuộc hôn_nhân kế của cha , trong mối quan_hệ với con chồng , không dùng để gọi
phụ_huynh	người cha hoặc người_mẹ ; người sinh_ra hay nuôi_dưỡng một đứa trẻ ; người họ_hàng đóng vai_trò người bảo_trợ
rỗi	không bận ; không bị ràng_buộc bởi nhiệm_vụ hoặc trách_nhiệm ; không bận ; không bị vướng_bận vào thứ khác ; không thực_hiện hay không có kế_hoạch làm nhiệm_vụ ; được nhàn_rỗi ; không có công_việc gì thúc_bách phải làm ngay , không bận_bịu ; trạng_thái được cứu_giúp , tránh khỏi nguy_hại
rỗi_rãi	được nhàn_rỗi ; không có công_việc gì thúc_bách phải làm ngay , không bận_bịu
tái_phát	[]
nhiễm_khuẩn	có chứa hoặc phát_sinh từ sinh_vật gây bệnh
mầm	( sinh_vật_học ) cấu_trúc sinh_sản_vô_tính nhỏ của thực_vật ; bộ_phận của thực_vật , giống với cái búp ; chồi mới phát lớn ( nhất_là từ hạt mới nảy mầm ) ; phần mới mọc nào ở một thực_vật , như một cành mới hay mầm
rau_quả	hoa_quả tươi hay rau được trồng để bán trên thị_trường ; cây nhiều lá hay có lá và gốc ăn được như rau
hạn_hán	thiếu mưa
lụt_lội	hiện_tượng một khối nước dâng lên và gây ra ngập cả một vùng rộng_lớn
lưỡng_lự	không chắc_chắn hành_động hay tiếp_tục như_thế_nào ; lưỡng_lự về điều gì đó ; ngập_ngừng giữa các quan_điểm hoặc hướng hành_động mâu_thuẫn ; chưa quyết_định được dứt_khoát vì có_điều còn e_ngại ; đắm_chìm trong suy_tư , sự cân_nhắc , hoặc cuộc tranh_luận ; hành_động do_dự , cho thấy sự không nhất_quán ; có sự do_dự ; dời đi một_cách chậm_chạp và lưỡng_lự ; lo_ngại , chần_chừ khi thực_hiện việc_gì ; tạm ngừng hoặc ngập_ngừng khi_không chắc_chắn hoặc miễn_cưỡng ; tạm ngừng hoặc ngập_ngừng khi_không chắc_chắn hoặc miễn_cưỡng ; lập_lờ nước_đôi , không rõ_ràng ; được đặc_trưng bởi thiếu sự quyết_đoán và sự vững_chắc ; thiếu tính quyết_đoán ; không_thể hành_động hoặc quyết_định một_cách nhanh_chóng hoặc vững_chắc ; thận_trọng , xem_xét và chưa đưa ra được quyết_định ; đặc_trưng bởi sự không quyết_đoán ; lung_lay trong ý_kiến hoặc quan_điểm ; lung_lay trong ý_kiến hoặc quan_điểm ; không được xác_định rõ_ràng
dứt_khoát	được xác_định một_cách rõ_ràng hoặc sắc_bén trong tâm_trí ; đặc_trưng bởi sự nhanh_chóng và chắc_chắn ; không cho_phép sự mâu_thuẫn hoặc từ_chối ; đặc_trưng nhờ sự quyết_định và tính chắc_chắn ; không có hạn_chế hay ngoại_lệ ; chính_xác và rõ_ràng hoặc dễ_dàng quan_sát được ; không để lại hàm_ý ; chấm_dứt tất_cả các tranh_cãi hoặc hành_động ; không_thể lầm ; được xác_định hoặc hình_thành rõ_ràng
tung	rải hay rắc lên trên một khu_vực ; ném lên hay tung lên chỉ với lực tác_động nhẹ ; tiến_hành hoặc thực_hiện ; ném hoặc đẩy đi theo một hướng cụ_thể hoặc hướng về một vật cụ_thể ; dùng cả cánh_tay đưa vật_thể vào không_trung ; hành_động hay cách_thức ném vật gì đó ; ném hoặc tung cái gì rất nhanh ; trải ra hay giăng ra , căng rộng từ một trạng_thái đóng hay cuộn ; tung xúc_xắc , như trong trò_chơi xúc_xắc ; gieo hạt bằng việc rắc ; tung nhẹ để xem_mặt nào lật lên ; tung ( con xúc_xắc ) lên một mặt_phẳng ; làm cho ( thông_tin ) đến với công_chúng
cấp_phát	cung_cấp hoặc ban cho , dưới dạng những phần nhỏ ; lưu_hành , phân_phát hay trang_bị cho ; phân_phát cho ; ban_tặng một_cách chính_thức ; cung_cấp thứ mong có hay cần đến , nhất_là sự động_viên , thực_phẩm hay phương_tiện sinh_sống
giầu	[]
khó	không may hay khó để chống_đỡ ; khó_khăn để thực_hiện ; đòi_hỏi sự nỗ_lực và kĩ_năng đáng_kể ; quá cầu_kì và dễ giận
làm_đẹp	trở_nên đẹp hơn để ngắm ; làm cho đẹp hơn
cải_tạo	hiện_đại_hoá hoặc nâng_cấp ; làm thay_đổi để cải_thiện và loại_bỏ tình_trạng lạm_dụng và bất_công ; làm cho tốt hơn ; làm cho có lại trạng_thái trước đó hoặc tốt hơn ; dẫn_dắt hay bắt_buộc từ_bỏ một hành_động sai hay hướng đi xấu trong cuộc_sống , kiểm_điểm và sửa_đổi theo một hướng đi đúng ; được cải_thiện về tinh_thần hay đạo_đức
ban_mai	thời_gian trong ngày , thời_điểm mà có ánh_sáng đầu_tiên
sớm_mai	[]
quỳ	dồn trọng_lượng lên đùi ; chất_chỉ_thị màu , chuyển thành đỏ khi tiếp_xúc với acid và chuyển thành xanh khi tiếp_xúc với base ; hạ ( người ) xuống bằng cách quỳ
ví	xem hay coi là tương_đương , bằng nhau hay giống nhau ; túi nhỏ dùng để đựng tiền ; đồ_dùng cỡ nhỏ bỏ_túi hoặc cầm tay , dùng để đựng giấy_tờ và tiền_mặt ; vật chứa dùng để đựng tiền và đồ_dùng cá_nhân hoặc phụ_kiện nhỏ ( đặc_biệt là của phụ_nữ )
bại_lộ	[]
lộ	bị tiết_lộ ra ngoài , bị lộ ra ngoài
tính_cách	tập_hợp những thuộc_tính vốn có quyết_định những hành_động và những phản_ứng có đạo_đức và có luân_lí của một người
phẩm_chất	thuộc_tính thiết_yếu và riêng_biệt của vật hay người ; tập_hợp những thuộc_tính vốn có quyết_định những hành_động và những phản_ứng có đạo_đức và có luân_lí của một người ; trình_độ chuyên_môn hay thuộc về tâm_sinh_lí làm_nên giá_trị con_người
triều_đại	thời_gian trị_vì của một ông vua hay một họ nhà_vua ; chuỗi người nối_tiếp nhau nắm quyền_lực mà thuộc vào cùng một gia_đình
cổ_đại	thuộc về thời quá_khứ xa , đặc_biệt là trong những giai_đoạn lịch_sử trước sự sụp_đổ của Đế_quốc La_Mã phương Tây ; thời_kì trước Trung_Cổ ở châu Âu ; lịch_sử về thế_giới cổ_đại
cõi_dương	[]
cõi_âm	nơi mình đến ở sau khi chết
lình_xình	[]
nặng_tình	[]
người_làm	người_làm một công_việc cụ_thể ; người chuyên làm_thuê cho tư_nhân ; người mà thực_hiện hành_động và làm các việc
người_bị_hại	[]
cõi_tục	thuộc trần_gian hay cõi_trần ; nơi cư_trú của con_người trên mặt_đất ( trong đối_lập với Thiên_Đường hay Địa_Ngục )
trần_gian	thuộc về trái_đất ; nơi cư_trú của con_người trên mặt_đất ( trong đối_lập với Thiên_Đường hay Địa_Ngục ) ; những lo_lắng về cuộc_đời này , khác_biệt với thiên_đàng và cái đến sau cái chết
chần_chừ	làm mất thời_gian của ai đó ; tiến_hành một_cách chậm_chạp ; di_chuyển tới và lui ; lưu lại hiện_tại mặc_dù dần mất đi hoặc dần phai đi ; trì_hoãn làm điều mà một người nên làm ; chưa quyết_định được dứt_khoát vì có_điều còn e_ngại ; đắm_chìm trong suy_tư , sự cân_nhắc , hoặc cuộc tranh_luận ; hành_động do_dự , cho thấy sự không nhất_quán ; dời đi một_cách chậm_chạp và lưỡng_lự ; dời đi một_cách chậm_chạp và lưỡng_lự ; tạm ngừng hoặc ngập_ngừng khi_không chắc_chắn hoặc miễn_cưỡng ; hoãn lại hay trì_hoãn không cần_thiết ; lập_lờ nước_đôi , không rõ_ràng ; được đặc_trưng bởi thiếu sự quyết_đoán và sự vững_chắc ; thiếu tính quyết_đoán ; không_thể hành_động hoặc quyết_định một_cách nhanh_chóng hoặc vững_chắc ; đặc_trưng bởi sự không quyết_đoán ; lung_lay trong ý_kiến hoặc quan_điểm ; không được xác_định rõ_ràng
lảo_đảo	di_chuyển không vững với chuyển_động lắc_lư ; bước_đi một_cách khó_nhọc ; dáng đi không vững_chắc ; không vững trong dáng đi như do thương_tật hoặc tuổi già ; ở trạng_thái mất cảm_giác về sự thăng_bằng ; đi như_thể không_thể kiểm_soát được những vận_động của mình ; di_chuyển không vững , như_thể sắp ngã ; di_chuyển chậm và không đều ; chuyển_động không vững
khử_trùng	giết các vi_sinh_vật và mầm bệnh bằng cách làm sạch ; làm hết vi_khuẩn ; có tính khử sạch hoặc diệt triệt_để các sinh_vật gây bệnh ; không có vi_sinh_vật nhiễm_bệnh hoặc được áp_dụng các phương_pháp để làm cho không có vi_sinh_vật nhiễm_bệnh ; hành_động diệt sạch vi_trùng , vi_khuẩn để làm sạch cái gì ; không có mầm bệnh hoặc các sinh_vật gây bệnh
sát_trùng	giết các vi_sinh_vật và mầm bệnh bằng cách làm sạch ; làm hết vi_khuẩn ; có tính khử sạch hoặc diệt triệt_để các sinh_vật gây bệnh
